髙	こう,たか
𣘸	べんど,べんどう
𠮷越	よしこし,よしごえ
𠮷道	よしみち,よしもと
塚越	つかこし,つかごし
髙階	たかがい,たかしな
髙見澤	たかみさわ,たかみざわ
髙砂	たかさご,たかすな
髙坂	こうさか,たかさか
髙山	こうやま,たかやま
髙城	たかぎ,たかしろ,たかじょう,たき
髙須賀	たかすか,たかすが
栁生	やぎう,やぎゅう
髙村	こうむら,たかむら
髙谷	たかたに,たかや
髙地	こうち,たかち
髙津	こうづ,こおず,たかつ
髙田	たかた,たかだ
栁内	やない,やなぎうち
髙畠	たかはた,たかばたけ
髙本	こうもと,たかもと
髙木	たかき,たかぎ
髙野	こうの,たかの
髙良	こうら,たから
髙澤	たかさわ,たかざわ
阿河	あが,あがわ
阿久井	あくい,あぐい
阿久戸	あくと,あくど
阿久沢	あいざわ,あくさわ,あくざわ
阿久澤	あいざわ,あくさわ,あくざわ
阿原	あはら,あわら
阿戸	あと,あど
阿江	あいえ,あえ
阿佐美	あさみ,あざみ
阿左美	あさみ,あざみ
阿妻	あずま,あづま
阿子島	あこしま,あこじま
阿出川	あでかわ,あでがわ
阿世知	あせち,あぜち
阿瀬知	あせち,あぜち
阿知波	あちは,あちわ
阿知葉	あちは,あちば
阿津	あつ,あづ
阿田川	あたがわ,あだがわ
阿刀田	あとうだ,あとだ
阿南	あなみ,あなん
阿波	あば,あわ
阿波根	あはごん,あわごん
阿波谷	あわたに,あわや
阿比野	あびの,あみの
阿美谷	あみたに,あみや
阿彦	あひこ,あびこ
阿品	あしな,あじな
阿武	あたけ,あぶ,あべ,あんの
阿閉	あつじ,あとじ,あべ
阿保	あぼ,あぼう,あぽ
阿万	あま,あまん
阿野	あの,あや
阿由葉	あゆは,あゆば
阿良	あら,あろう
阿萬	あずま,あま,あまん
阿萬田	あまた,あまだ
愛月	あいつき,あいづき
愛甲	あいかわ,あいこう
愛沢	あいさわ,あいざわ
愛知	あいち,えち
愛宕	あたご,おたぎ
愛澤	あいさわ,あいざわ
逢見	おうみ,おおみ
逢坂	あいさか,おうさか,おおさか
逢阪	あいさか,おおさか
逢沢	あいさわ,あいざわ
逢澤	あいさわ,あいざわ
旭岡	あさひおか,ひのおか
葦津	あしつ,あしづ
芦岡	あしおか,よしおか
芦原	あしはら,あしばら,あしわら
芦崎	あしさき,あしざき
芦生	あしお,あしおい
芦谷	あしたに,あしや
芦田	あした,あしだ
芦硲	あしさこ,あしたに
芦部	あしぶ,あしべ
芦立	あしたて,あしだて,あだち
飴谷	あめたに,あめや
綾戸	あやと,あやど
綾城	あやき,あやしろ
綾田	あやた,あやだ
鮎貝	あゆかい,あゆがい
鮎川	あいかわ,あゆかわ
鮎沢	あいざわ,あゆさわ,あゆざわ
鮎澤	あいざわ,あゆさわ,あゆざわ
粟原	あいはら,あわはら
粟国	あぐに,あわくに
粟山	あわやま,もみやま
粟生	あお,あおう,あわお
粟生田	あおうだ,あおた
粟谷	あわたに,あわや
粟津	あわず,あわつ,あわづ
粟津原	あわつはら,あわづはら
粟飯原	あいはら,あいばら,あわいはら,あわいばら
粟野	あわの,あわや
安	あん,やす
安髙	あたか,やすたか
安雲	あずみ,やすくも
安延	やすのぶ,やすのべ
安海	あずみ,あつみ,あづみ,あんかい,やすうみ
安間	あんま,やすま
安喜	あき,やすき
安久	あく,あぐ,あんきゅう,やすひさ
安久井	あくい,あぐい
安居	あぐい,あんきょ,やすい
安居院	あぐい,あぐいん
安喰	あぐい,あじき,あんじき
安形	あがた,やすがた
安慶田	あげた,あげだ
安慶名	あけな,あげな
安見	あずみ,あみ,やすみ
安高	あたか,やすたか
安細	あんさい,あんざい
安坂	あさか,やすさか,やすざか
安崎	あんざき,やすざき
安酸	やすかた,やすたか
安次富	あしとみ,あじとみ
安次嶺	あしみね,あじみね
安室	あじつ,やすむろ
安食	あじき,あぢき,あんじき
安心院	あじみ,あじむ
安西	あんざい,あんぜい,やすにし
安斉	あんさい,あんざい
安積	あさか,あずみ,あづみ
安川	あがわ,やすかわ
安曽	あそ,あんそ
安増	あそう,やすます
安蔵	あんぞう,やすくら
安代	あじろ,あんだい
安宅	あたか,あたぎ,あたけ
安沢	あんざわ,やすざわ
安達	あだち,あんだち
安谷屋	あだにや,やすたにや
安中	あんなか,やすなか
安仲	あんなか,やすなか
安田	やすた,やすだ
安土	あづち,あんづち,あんど
安島	あじま,やすじま
安嶋	あじま,やすしま,やすじま
安濃	あんの,あんのう
安倍	あべ,あんばい,あんべ
安彦	あひこ,あびこ,やすひこ
安蒜	あびる,あんびる
安冨	やすとみ,やすどみ
安部	あべ,あんべ
安福	あぶく,あんぷく,やすふく
安保	あぼ,あぼう,あんぼ,あんぽ,やすほ
安方	あがた,やすかた
安木	やすき,やすぎ
安野	あんの,やすの
安里	あさと,やすざと
安立	あだち,あんだち,あんりゅう
安良城	あらき,あらしろ
安陵	あんりょう,やすおか
安澤	あんざわ,やすざわ
庵	いおり,いほり
庵原	あいはら,いおはら,いはら,いばら
庵崎	あんざき,いおさき,いおりざき
庵谷	いおたに,いおりだに,いおりや,おおたに
伊ケ崎	いがさき,いけざき
伊ヶ崎	いかさき,いかざき,いがさき,いけざき
伊永	いなが,これなが
伊加	いか,いが
伊賀崎	いかざき,いがさき
伊関	いせき,いぜき
伊規須	いきす,いぎす
伊熊	いくま,いぐま
伊月	いずき,いつき,いづき
伊香	いか,いこう
伊佐地	いさじ,いさち,いさぢ
伊崎	いさき,いざき
伊集	いしゅう,いじゅ,いじゅう
伊集院	いしゅういん,いじゅういん
伊神	いかみ,いがみ
伊勢崎	いせさき,いせざき
伊勢谷	いせたに,いせや
伊勢島	いせしま,いせじま
伊川	いかわ,いがわ
伊倉	いくら,いぐら
伊早坂	いそさか,いはやさか
伊大知	いおおち,いおち
伊沢	いさわ,いざわ
伊達	たて,だて
伊達木	だてき,だてぎ
伊地知	いじち,いちじ,いぢち
伊津野	いずの,いつの,いづの
伊島	いしま,いじま
伊豆津	いずつ,いづつ
伊能	いのう,いよく
伊波	いなみ,いは
伊比	いひ,いび
伊平	いだいら,いひら
伊木	いき,いぎ
伊与田	いよた,いよだ
伊良波	いらなみ,いらは
伊礼	いれ,いれい
伊豫田	いよた,いよだ
伊澤	いさわ,いざわ
伊與田	いよた,いよだ
位下	いげ,いした
位田	いだ,いんでん
依田	いだ,よだ,よりた
為久	いきゅう,ためひさ
衣川	きぬかわ,きぬがわ,ころもがわ
衣袋	いふくろ,いぶくろ
衣斐	いび,えひ,えび,えみ
井	い,いい,いづつ,いのもと,さらい
井ノ口	いのくち,いのぐち
井ヶ田	いけだ,いげた
井越	いこし,いごし
井延	いのぶ,いのべ
井奥	いおく,いのおく
井岡	いおか,いのおか
井貝	いかい,いがい
井街	いがい,いまち
井関	いせき,いぜき
井汲	いくみ,いぐみ
井元	いのもと,いもと
井原	いはら,いばら
井戸川	いとがわ,いどかわ,いどがわ
井戸田	いとだ,いどた
井口	いぐち,いのくち,いのぐち
井高	いたか,いだか
井合	いあい,いごう
井黒	いくろ,いぐろ
井崎	いさき,いざき
井手	いて,いで
井手上	いでうえ,いでがみ
井手田	いてだ,いでた
井出上	いでうえ,いでがみ
井上	いかみ,いのうえ
井城	いいき,いき,いのしろ
井植	いうえ,いのうえ
井尻	いじり,いのしり
井神	いかみ,いがみ,いのかみ
井水	いすい,いみず
井生	いお,いおい,いおう,いのいけ
井石	いいし,いせき
井川	いかわ,いがわ
井倉	いくら,いぐら,いのくら
井沢	いさわ,いざわ
井地	いじ,いぢ
井塚	いつか,いづか
井爪	いづめ,いのつめ
井土	いづち,いど
井島	いしま,いじま
井藤	いとう,いふじ
井内	いうち,いない,いのうち
井之口	いのくち,いのぐち
井波	いなみ,いば
井畑	いはた,いばた
井樋	いとい,いび
井尾	いお,いのお
井辺	いべ,いんべ
井堀	いほり,いぼり
井本	いのもと,いもと
井面	いづら,いのも
井門	いかど,いど,いもん
井脇	いのわき,いわき
井澤	いさわ,いざわ
井邊	いなべ,いんべ
磯谷	いそがい,いそがや,いそたに,いそや
磯内	いそうち,いそち
磯畑	いそはた,いそばた
一	いち,にのまえ,はじめ
一井	いちい,いちのい,ひとつい
一家	いっか,ひとつや
一花	いちはな,いっか
一角	いちかく,いちずみ
一宮	いちのみや,いちみや
一鍬田	ひとくわた,ひとくわだ
一見	いちみ,かずみ
一戸	いちのえ,いちのへ
一志	いちし,いっし
一氏	いちうじ,ひとうじ,ひとじ
一尺八寸	かまつか,かまづか
一松	いちまつ,ひとまつ
一上	いちかみ,いちがみ
一色	いしき,いっしき
一杉	いちすぎ,ひとすぎ
一寸木	ちょっき,ますぎ
一瀬	いちせ,いちのせ,いっせ
一青	しとと,ひとと
一番ヶ瀬	いちばかせ,いちばんがせ
一番合戦	いちばんがせ,いちばんがっせん,いちまかせ
一筆	いっぴつ,ひとふで
一方井	いちかたい,いっかたい,いつかたい
一法師	いちほうし,いっぽうし
一本	いちもと,ひともと
一木	いちき,いつき,ひとき
一柳	いちやなぎ,いちりゅう,ひとつやなぎ
壱崎	いちさき,いちざき
逸見	いつみ,へんみ
逸崎	いつさき,いつざき
稲	いな,いね
稲井	いない,いねい
稲永	いななが,いねなが
稲熊	いなくま,いなぐま
稲継	いなつぎ,いなつぐ
稲月	いなつき,いなづき,いねづき
稲崎	いなさき,いなざき
稲山	いなやま,いねやま
稲子	いなこ,いなご
稲次	いなじ,いなつぎ
稲手	いなて,いなで
稲生	いなお,いなぶ,いのう,いのお
稲積	いなずみ,いなづみ
稲川	いなかわ,いながわ
稲谷	いなたに,いなや
稲津	いなず,いなつ,いなづ
稲塚	いなつか,いなづか
稲田	いなた,いなだ
稲波	いななみ,いなば,いなみ
稲畑	いなはた,いなばた
稲富	いなとみ,いなどみ
稲毛	いなげ,いなも
稲毛田	いなげた,いなげだ
稲木	いなき,いなぎ
稲野	いなの,いねの
稲留	いなとめ,いなどめ
稲澤	いなさわ,いなざわ
茨田	ばらた,ばらだ,まんだ
茨木	いばらき,いばらぎ,ばらき
芋生	いもう,いもお
印東	いんとう,いんどう
因	いん,ちなみ
引地	ひきじ,ひきち,ひきぢ
引田	ひきた,ひきだ
引頭	いんとう,いんどう
陰地	おおじ,おおぢ,おんじ
陰能	いんの,いんのう
隠田	おんだ,かくれだ
右井	うい,みぎい
右手	うて,みぎて
右川	うかわ,うがわ
宇髙	うたか,うだか,うだが
宇栄原	うえはら,うえばる
宇賀	うか,うが
宇賀神	うかがみ,うがじん
宇戸	うと,うど
宇高	うたか,うだか
宇治橋	うじはし,うじばし
宇治郷	うじこう,うじごう
宇治川	うじかわ,うじがわ
宇宿	うしゅく,うすき,うすく
宇吹	うすい,うぶき
宇川	うかわ,うがわ
宇多	うた,うだ
宇多小路	うたこうじ,うたこぢ
宇地原	うじはら,うちはら
宇津	うつ,うづ
宇津宮	うつのみや,うつみや
宇津木	うつき,うつぎ
宇田川	うたがわ,うだがわ
宇都	うつ,うと,うど
宇都木	うつき,うつぎ
宇土	うと,うど
宇那木	うなき,うなぎ
宇良	うら,うりょう
烏田	うだ,からすだ
烏帽子田	えぼした,えぼしだ
烏野	うの,からすの
羽下	はが,はげ
羽角	はかく,はすみ
羽間	はざま,はま
羽金	はがね,はねかね
羽喰	はくい,はぐい
羽月	はつき,はづき
羽根川	はねかわ,はねがわ
羽坂	はさか,はざか
羽子田	はねた,はねだ
羽取	はとり,はどり
羽住	はすみ,はずみ,はづみ
羽深	はふか,はぶか
羽生	はにう,はにゅう,はぶ
羽生田	はにうだ,はにゅうだ
羽石	はいし,はねいし
羽川	はがわ,はねかわ
羽染	はそめ,はぞめ
羽倉	はくら,はぐら
羽谷	はたに,はだに
羽地	はじ,はねじ
羽中田	はちゅうだ,はなかた
羽鳥	はとり,はどり,はねとり
羽田	はた,はだ,はねた,はねだ
羽田野	はたの,はだの
羽島	はしま,はじま,はねしま
羽二生	はにう,はにゅう
羽入	はにゅう,はねいり
羽馬	はば,はま
羽白	はしろ,はじろ
羽部	はぶ,はべ
羽毛田	はけた,はけだ
羽里	はざと,はり
雨海	あまかい,あまがい
雨宮	あまみや,あめみや
雨坂	あまさか,あめさか
雨森	あまもり,あめのもり,あめもり
雨川	あまかわ,あめかわ
雨谷	あまがい,あまたに,あまや,あめたに,あめや
雨堤	あまつづみ,あまづつみ,あめつつみ,あめづつみ
雨田	あまだ,あめた,あめだ
雨島	あめしま,あめじま
雨澤	あめざわ,うざわ
卯花	うのはな,うばな
卯木	うき,うのき
鵜久森	うくもり,うぐもり
鵜飼	うかい,うがい
鵜狩	うかり,うがり
鵜川	うかわ,うがわ
浦崎	うらさき,うらざき
浦上	うらかみ,うらがみ
浦尻	うらしり,うらじり
浦谷	うらたに,うらや
浦添	うらそえ,うらぞえ
瓜生	うりう,うりゅう
瓜生原	うりうばら,うりゅうはら
瓜谷	うりたに,うりや
雲地	うんじ,くもじ
雲母	きら,きらら
雲林	うんりん,くもばやし
荏原	あいはら,えはら,えばら
栄	えい,さかい,さかえ
栄田	えいだ,さかえた,さかえだ
栄藤	えいとう,えとう
栄野比	えのひ,えのび
永	えい,なが,ながい
永栄	えいよう,ながえ
永園	ながその,ながぞの
永久	えいきゅう,ながひさ
永戸	えいと,ながと
永光	なかみつ,ながみつ
永坂	えいさか,ながさか
永崎	えいさき,ながさき
永森	えいもり,ながもり
永川	えいかわ,えがわ,ながかわ
永村	えむら,ながむら
永谷	ながたに,ながや
永地	えいじ,ながち
永長	えいなが,ながおさ
永島	えいしま,えいじま,ながしま
永藤	えいとう,ながとう,ながふじ
永富	ながとみ,ながどみ
永福	えいふく,ながふく
永淵	ながふち,ながぶち
永柄	えがら,ながえ
永野	えいの,ながの
永用	えいよう,ながよう
永来	えいらい,えら,ながき
永留	ながとめ,ながどめ
永廣	えひろ,ながひろ
永渕	ながふち,ながぶち
永澤	えいざわ,ながさわ
英	あなた,えい,はなふさ,はなぶさ
英賀	あが,えいが
英保	あぼ,えいほ
詠	ながみ,ながめ
益	えき,ます
益戸	ますと,ますど
益子	ましこ,ますこ
益田	ました,ますだ
越間	えつま,こしま
越湖	えっこ,こしこ
越坂	こしさか,こしざか
越坂部	おさかべ,こさかべ
越崎	えつさき,こしざき
越川	えちかわ,こしかわ
越前	えちぜん,こしまえ
越谷	こしたに,こしや
越地	こしじ,こしぢ
越智	おち,こえち
越中	えっちゅう,こしなか
越田	こした,こしだ
越路	こいじ,こいろ,こえじ,こしじ
榎原	えのきはら,えのはら,えはら,えばら
榎戸	えのきと,えのきど,えのと
榎坂	えさか,えのきざか
榎森	えのもり,えもり
榎村	えのむら,えむら
榎谷	えのきだに,えのたに
榎島	えのきじま,えのしま
榎畑	えのきはた,えのきばた
榎本	えのもと,えもと
円井	つぶらい,まるい
円山	えんざん,まるやま
円谷	えんや,つぶらや,つむらや
園城	えんじょう,おんじょう,そのき,そのしろ
延	のぶ,のべ
延岡	のぶおか,のべおか
延原	のぶはら,のべはら
延山	のぶやま,のべやま
延川	のぶかわ,のべかわ
延沢	のぶさわ,のべざわ
延谷	のぶたに,のべたに
延田	のぶた,のべた
延島	のぶしま,のべしま
延藤	えんどう,のぶとう
延澤	のぶさわ,のべさわ
煙山	けむやま,けむりやま
猿橋	さはし,さるはし
猿子	さるこ,ましこ
猿谷	さるたに,さるや
猿渡	えんど,さるわたり,さわたり
遠間	とうま,とおま
遠座	えんざ,おんざ
遠山	とうやま,とおやま
遠城	えんじょう,おんじょう
遠谷	えんたに,とおや
遠田	えんた,えんだ,とおだ
遠島	とおしま,とおじま
遠嶋	とおしま,とおじま
遠峰	とうみね,とおみね
遠矢	とうや,とおや
鴛海	おしうみ,おしのみ
塩原	しおはら,しおばら
塩崎	しおさき,しおざき
塩生	しおにゅう,しおの
塩多	しおた,しおだ
塩谷	えんや,しおたに,しおのや,しおや
塩地	しおじ,しおち
塩津	しおつ,しおづ
塩塚	しおつか,しおづか
塩田	しおた,しおだ
塩梅	あんばい,しおうめ
塩飽	しあき,しあく,しおあき,しわく
塩澤	しおざわ,しおつ
於久	おく,おぐ
於保	おほ,おぼ
奥宮	おくのみや,おくみや
奥原	おくはら,おくばら
奥戸	おくと,おくど
奥沢	おくさわ,おくざわ
奥谷	おくたに,おくや
奥田	おくた,おくだ
奥島	おくしま,おくじま
奥嶋	おくしま,おくじま
奥藤	おくとう,おくふじ
奥平	おくだいら,おくひら
奥坊	おくぼ,おくぼう
奥里	おくさと,おくざと
奥澤	おくさわ,おくざわ
押	おさえ,おし
押井	おさい,おしい
押上	おしあげ,おしかみ,おしがみ
押切	おしきり,おしぎり
押樋	おうとい,おおとい
横家	よこいえ,よこや
横関	よこせき,よこぜき
横崎	よこさき,よこざき
横須賀	よこすか,よこすが
横川	よこかわ,よこがわ
横沢	よこさわ,よこざわ
横谷	よこたに,よこや
横地	よこち,よこぢ
横塚	よこつか,よこづか
横島	よこしま,よこじま
横畠	よこはた,よこばたけ
横尾	よこお,よこを
横堀	よこほり,よこぼり
横木	よこき,よこぎ
横野	おおの,よこの
横路	よこみち,よころ
横澤	よこさわ,よこざわ
王丸	おうまる,おおまる
王子谷	おうじたに,おおじや
王子田	おうしでん,おうじだ
王鷲	おうわし,おおわし
翁	おう,おきな
黄海	おうみ,きうみ
黄地	おうじ,おうち
黄田	きだ,こうだ
黄木	おうき,おうぎ,おおき
岡上	おかうえ,おかがみ,おかのうえ
岡城	おかき,おかぎ
岡谷	おかたに,おかのや,おかや
岡端	おかはた,おかはな,おかばた
岡地	おかじ,おかち,おかぢ
岡登	おかと,おかのぼり
岡南	おかなみ,おかなん
沖田	おきた,おきだ
荻原	おぎはら,おぎわら
荻生	おぎう,おぎゅう
荻谷	おぎたに,おぎや
荻布	おぎぬの,おぎの
屋嘉部	やかぶ,やかべ
屋宜	やぎ,やじ
屋形	やかた,やがた
屋部	やぶ,やべ
屋本	おくもと,やもと
桶屋	おけや,ひおく
桶川	おけかわ,おけがわ
桶谷	おけたに,おけや
乙黒	おつぐろ,おとぐろ
乙骨	おっこつ,おつこつ
乙川	おつかわ,おとかわ,おとがわ
乙津	おつ,おとづ
乙幡	おっぱた,おつはた,おつぱた,おとはた
恩地	おんじ,おんち,おんぢ
恩田	おんた,おんだ
音琴	おとごと,ねごと
音川	おとかわ,おとがわ
音田	おとだ,おんだ
音頭	おんど,おんどう
下	した,しも
下雲	したくも,しもくも
下河	しもかわ,しもがわ
下河原	しもかわら,しもがわら
下河内	しもこうち,しもごうち
下河辺	しもかわべ,しもこうべ
下垣	したがき,しもがき
下垣内	しもがいち,しもがいと
下間	しもつま,しもま
下久保	したくぼ,しもくぼ
下休場	したやすんば,しもやすば
下郷	しもごう,しもざと
下見	したみ,しもみ
下原	したはら,しもはら
下戸	おりと,かと,さげど,しもと,しもど
下向	したむかい,しもむかい,しもむき
下妻	しもずま,しもつま,しもづま
下坂	したさか,しもさか
下崎	しもさき,しもざき
下司	げし,げじ,しもし,しもじ,しもつか,しもつかさ
下志万	しもしま,しもじま
下重	しもしげ,しもじゅう
下出	しもいで,しもで
下小路	したこうじ,しもこうじ
下条	げじょう,しもじょう
下森	げもり,したもり,しももり
下清水	したしみず,しもしみず
下西	したにし,しもにし
下川	しもかわ,しもがわ
下川原	しもかわら,しもがわら
下谷	しただに,しもたに,しもや
下地	しもじ,しもち,しもぢ
下中	したなか,しもなか
下津	しもつ,しもづ
下内	しもうち,しもち
下之薗	しものその,しものぞの
下迫	したさこ,しもさこ
下畑	しもはた,しもばた
下飯	しもい,しもいい
下平	しもだいら,しもひら
下保	かほ,しもやす
下方	したかた,しもかた
下坊	したぼう,しもぼう
下末	したすえ,しもすえ
下門	しもかど,しもじょう,しもん
下里	しもさと,しもざと
下嶽	しもたけ,しもだけ
下條	げじょう,しもじょう
下澤	しもさわ,しもざわ
仮谷	かりたに,かりや
佳山	かやま,よしやま
加悦	かえつ,かや
加賀谷	かがたに,かがや
加計	かけ,かけい
加戸	かと,かど
加持	かじ,かもち
加瀬谷	かせがい,かせたに,かせや
加勢	かせ,かせい
加太	かだ,かぶと
加谷	かたに,かや
加地	かじ,かち,かぢ
加登	かと,かとう
加島	かしま,かじま
加納	かの,かのう
加幡	かば,かばた
加畑	かはた,かばた,かぱた
加部東	かぶと,かぶとう
加木	かき,かぎ
加覧	からん,がらん
可児	かじ,かに
嘉戸	かと,かど
嘉手苅	かてかり,かてがり,かてがる,かでかる
嘉手川	かてがわ,かでかわ
嘉手納	かてな,かでな
嘉数	かかず,かすう
嘉瀬	かせ,かぜ
嘉村	かむら,よしむら
嘉納	かのう,きな
嘉野	かの,よしの
夏越	なつこし,なつごえ
夏苅	なつかり,なつがり
夏堀	なつほり,なつぼり
家垣	いえがき,やがき
家亀	いえかめ,やがめ
家郷	いえごう,いえさと
家口	いえぐち,かぐち
家高	いえたか,やたか,やだか
家崎	いえさき,いえざき
家治	いえじ,かじ,やじ
家守	かもり,やもり
家城	いえき,やしろ
家森	いえもり,やもり
家塚	いえつか,いえづか
家島	いえしま,いえじま
家本	いえもと,けもと
歌津	うたつ,うたづ
河角	かわかど,かわすみ
河原	かわはら,かわら,ごうばら
河原井	かわはらい,かわらい
河原崎	かわらさき,かわらざき
河原田	かわはらだ,かわらだ
河戸	かわと,かわど
河口	かわぐち,こうぐち
河済	かわすみ,かわずみ
河澄	かわすみ,かわずみ
河西	かさい,かわにし
河相	かあい,かわあい,かわい
河村	かわむら,こうむら
河谷	かわたに,こうたに
河端	かわはた,かわばた
河地	かわじ,かわち
河津	かわず,かわつ,かわづ,こうつ
河添	かわそい,かわそえ,かわぞえ
河田	かわた,かわだ
河島	かわしま,こうしま
河東	かとう,かわとう,かわひがし
河内	かわうち,かわち,こうち
河内山	かわちやま,こうちやま
河南	かわなみ,かわみなみ,かんなん
河埜	かわの,こうの
河辺	かべ,かわなべ,かわべ,こうべ
河本	かわもと,こうもと
河面	かわづら,こうも
河野	かわの,こうの,こおの
河渕	かわぶち,こうぶち
河邉	かわべ,こうべ
火原	ひはら,ひばら
花﨑	はなさき,はなざき
花家	はないえ,はなけ
花角	はなかど,はなずみ
花見	けんみ,はなみ
花原	はなはら,はなばら
花崎	はなさき,はなざき
花山院	かさのいん,かさんのいん
花谷	はなたに,はなや
花田	はなた,はなだ
花島	はなしま,はなじま
花嶋	はなしま,はなじま
花畑	はなはた,はなばた
花房	はなふさ,はなぶさ
花里	はなさと,はなざと
茄子川	なすかわ,なすがわ
荷宮	にのみや,にみや
荷川取	にかどり,にかわどり
華表	かひょう,とりい
蚊爪	かがつめ,かづめ
我妻	あがつま,あずま,あづま,わがつま
我謝	がしゃ,がじゃ
我谷	がや,わがたに
我部	がぶ,がべ
我満	がまん,わがみつ
賀内	かうち,がうち
会田	あいた,あいだ
廻	まわり,めぐり,めぐる
廻田	かいだ,さこた
改田	かいだ,かいでん
海﨑	うみざき,かいざき
海原	うなばら,うみはら,かいはら
海山	うみやま,かいさん,かいざん,わだやま
海住	かいじゅう,かいずみ
海上	うなかみ,うながみ,かいじょう
海瀬	うみせ,かいせ
海川	うみかわ,かいかわ
海地	うみじ,うみぢ
海津	うみづ,かいず,かいづ
海田	うみだ,かいた,かいだ,かいでん
海渡	かいと,かいど
海東	かいとう,かいどう
海藤	かいとう,かいどう
海内	うみうち,かいだい,かいない
海部	かいふ,かいべ
海辺	うみべ,かいべ
海堀	かいほり,かいぼり
海本	うみもと,かいもと
海野	うの,うみの,うんの,かいの
海老	えび,かいろう
海老子川	えびしかわ,えびしがわ
海老沢	えびさわ,えびざわ
海老澤	えびさわ,えびざわ
海渕	うみふち,かいふち,かいぶち
灰原	かいはら,かいばら
灰谷	はいたに,はいや
灰庭	はいにわ,はいば
皆月	みなつき,みなづき
皆元	かいもと,みなもと
皆合	かいごう,みなあい
皆川	みなかわ,みながわ
皆藤	かいとう,かいどう
皆木	みなき,みなぎ
絵内	えうち,えない
絵面	えずら,えづら
芥川	あいかわ,あくたがわ
開	かい,ひらき
開原	かいはら,ひらきばら
開坂	かいさか,かいざか
開田	かいだ,ひらきだ
開発	かいはつ,かいほつ
開米	かいごめ,かいまい
開澤	かいざわ,ひらきざわ
貝原	かいはら,かいばら
貝川	かいかわ,かいがわ
貝沢	かいさわ,かいざわ
貝谷	かいたに,かいや
貝塚	かいつか,かいづか
貝田	かいた,かいだ
貝淵	かいふち,かいぶち
外賀	げか,げが
外海	そとみ,とのがい
外間	そとま,ほかま
外丸	そとまる,とまる
外口	そとぐち,とぐち
外崎	そとざき,とのさき,とのざき
外山	そとやま,とやま
外川	そとかわ,とがわ
外村	とのむら,とむら,ほかむら
外谷	そとや,とや
外池	といけ,とのいけ
外田	そとだ,ほかだ
外尾	そとお,ほかお
外木	そとき,とのき
外立	そとだて,はしだて
鎧	あぶみ,よろい
垣花	かきのはな,かきはな
垣見	かきみ,かけひ
垣内	かいと,かいとう,かきうち
柿沢	かきさわ,かきざわ
柿谷	かきたに,かきだに,かきや
柿迫	かきさこ,かきざこ
柿平	かきだいら,かきひら
柿木	かきき,かきぎ,かきのき
柿木原	かきのきはら,かきはら
柿澤	かきさわ,かきざわ
各務	かかみ,かかむ,かがみ,かくむ
覚前	かくぜん,かくまえ
覚張	かくはり,がくはり
覚田	かくた,かくだ
角	かく,かど,すみ,つの
角井	かくい,すみい,つのい
角岡	かどおか,つのおか
角屋	かくや,かどや,すみや,やどや
角屋敷	かどやしき,すみやしき
角河	すみかわ,すみがわ
角海	かくうみ,かどうみ
角舘	かくだて,かくのだて
角原	かくはら,かどはら
角江	かくえ,すみえ
角崎	かくざき,かどさき,かどざき,つのざき
角山	かくやま,かどやま,つのやま
角森	かくもり,つのもり
角石	かくいし,かどいし
角川	かくがわ,かどかわ,すみかわ,つのかわ
角前	かくぜん,かどまえ
角倉	かどくら,すみくら
角村	かどむら,すみむら,つのむら
角替	つのがい,つのがえ
角沢	かくさわ,かどさわ
角谷	かくたに,かくや,かたたに,かどたに,かどや,すみたに,すみや,つのや
角地	かくち,つのじ
角田	かくた,かくだ,かどた,すみた,すみだ,つのだ
角島	かくしま,かどしま
角嶋	かくしま,かどしま
角藤	かくとう,かくどう
角南	すなみ,すみなみ,つなみ
角埜	かくの,かどの
角尾	かくお,かどお,すみお,つのお
角浜	かくはま,かどはま
角本	かくもと,かどもと
角野	かくの,かどの,すみの,つの
角矢	かくや,かどや
岳	おか,がく
額谷	ぬかたに,ぬかや
額田	ぬかた,ぬかだ
掛川	かけかわ,かけがわ
掛谷	かけたに,かけや
掛田	かけた,かけだ
笠	かさ,りゅう
笠川	かさかわ,かさがわ
笠谷	かさたに,かさや
笠置	かさおき,かさき,かさぎ
笠島	かさしま,かさじま
笠嶋	かさしま,かさじま
笠木	かさき,かさぎ
樫木	かしき,かしのき
梶原	かじはら,かじわら,かぢわら
梶崎	かじさき,かじざき
梶谷	かじたに,かじや
梶塚	かじつか,かじづか,かぢつか
梶本	かじもと,かぢもと
潟渕	かたふち,かたぶち
割鞘	わりさや,わりざや
割澤	わりさわ,わりざわ
滑川	なめかわ,なめりかわ
葛	かつ,くず
葛井	かつい,かつらい,ふじい
葛原	かつはら,くずはら
葛山	かつやま,かつらやま,かづらやま,くずやま
葛上	くずかみ,くずがみ
葛城	かつらぎ,くずき
葛生	くずう,くづう
葛西	かさい,かっさい,かつさい,くずにし
葛谷	かつたに,くずたに,くずや
葛田	かつた,かつらだ,くずた
葛島	かどしま,くずしま
葛馬	かつま,かつらうま,くずま
葛迫	かつさこ,かつせこ,かつらさこ
葛綿	かつわた,くずわた
葛野	かどの,くずの
葛葉	くずは,くずば
叶	かの,かのう
叶谷	かなたに,かのうや
叶内	かなうち,かのうち
椛沢	かばさわ,がわさわ
椛島	かばしま,かばじま
樺島	かばしま,かばじま
蒲	かば,かま,がま
蒲原	かまはら,かもはら,かんばら
蒲生	かまう,かもう,がも,がもう
蒲沢	かばさわ,がわさわ
蒲地	かまち,かもち
蒲田	かまた,がばた,がまた,がまだ
蒲澤	かまさわ,かまざわ
釜谷	かまたに,かまや
釜田	かまた,かまだ
釜鳴	かまなり,かまなる
鎌原	かまはら,かんばら
鎌崎	かまさき,かまざき
鎌上	かまかみ,かみがみ
鎌谷	かまたに,かまや
鎌仲	かまなか,なまなか
鎌塚	かまつか,かまづか
鎌田	かまた,かまだ
鴨崎	かもさき,かもざき
鴨田	かもた,かもだ
栢原	かやはら,かやばら
栢木	かやき,かやのき
茅原	かやはら,ちはら
茅根	かやね,ちのね
茅島	かやしま,かやじま
茅野	かやの,ちの
萱島	かやしま,かやじま
粥川	かゆかわ,かゆがわ
刈込	かりこみ,かりこめ
苅込	かりこみ,かりごめ
苅宿	かりしゅく,かりやど
苅田	かりた,かんだ
苅部	かりべ,かるべ
瓦谷	かわらたに,かわらだに
寒川	かんかわ,かんがわ,さがわ,さむかわ,さんがわ,そうかわ,そうがわ
寒竹	かんたけ,かんちく
寒風	かんぷう,さむかぜ
勘川	かんかわ,かんがわ
巻端	まきはし,まきはま
官能	かんの,かんのう
幹	かん,みき
甘崎	あまさき,あまざき
甘中	あまなか,かんなか
甘粕	あまかす,あまがす
管	かん,すが
管家	かんけ,すがや
管原	すがはら,すがわら
肝付	きもつき,きもつけ
貫井	ぬきい,ぬくい
貫名	かんめい,ぬきな
間	あいだ,はざま
間下	ました,ましも
間崎	まさき,まざき
間谷	あいたに,あいだに
間地	あいち,まぢ
間中	けんちゅう,まなか
間塚	まつか,まづか
間島	ましま,まじま
間嶋	ましま,まじま
間鍋	かんなべ,まなべ
間馬	あいば,けんま
間部	まなべ,まぶ,まべ
間明田	まみょうだ,まみよだ
閑野	かんの,しずの
関原	かんばら,せきはら
関戸	せきと,せきど
関川	せきかわ,せきがわ
関谷	せきたに,せきや
関田	せきた,せきだ
関島	せきしま,せきじま
関藤	せきとう,せきふじ
館	たち,たて
館花	たちばな,たてはな
館盛	たちもり,たてもり
舘	たち,たて
舘下	たちした,たてした
舘久	たちひさ,たてひさ
舘盛	たちもり,たてもり
舘田	たちだ,たてだ
舘野	たちの,たての
舘澤	たてさわ,たてざわ
丸橋	まるはし,まるばし
丸谷	まるたに,まるや
丸塚	まるつか,まるづか
丸藤	がんとう,がんどう,まるふじ
丸澤	まるさわ,まるざわ
岸上	きしうえ,きしがみ
岸川	きしかわ,きしがわ
岸谷	きしたに,きしや
岸端	きしはた,きしばた
岸木	きしき,きしぎ
岩久	いわく,いわひさ
岩隈	いわくま,いわぐま
岩戸	いわと,いわど
岩口	いわくち,いわぐち
岩佐	いわさ,ゆあさ
岩出	いわいで,いわで
岩楯	いわたて,いわだて
岩上	いわかみ,いわがみ
岩城	いわき,いわしろ
岩垂	いわたれ,いわだれ
岩川	いわかわ,いわがわ
岩浅	いわあさ,いわさ
岩谷	いわたに,いわや
岩塚	いわつか,いわづか
岩槻	いわき,いわつき
岩島	いわしま,いわじま
岩藤	いわとう,いわどう,いわふじ
岩畔	いわくろ,いわぐろ
岩部	いわぶ,いわべ
岩淵	いわふち,いわぶち
岩辺	いわなべ,いわべ
岩立	いわたて,いわだて
岩渕	いわふち,いわぶち
雁瀬	かりせ,がんせ
喜々津	ききつ,ききづ
喜岡	きおか,よしおか
喜屋武	きゃん,きやたけ,きやん
喜舎場	きしゃば,きゃしゃば
喜多	きた,きだ
喜多嶋	きたしま,きたじま
喜谷	きたに,きだに
喜田	きた,きだ
喜納	きな,きのう
喜友名	あにや,きゅうな,きゆうな,きゆな
喜連川	きつれがわ,きれかわ
寄川	よせかわ,よりかわ
寄田	きだ,よりた
希代	きたい,きだい
帰山	かえりやま,きやま
気賀澤	きがさわ,けがさわ
気仙	きせん,けせん
稀代	きしろ,きたい
紀	き,きの
貴家	きや,さすが
貴船	きふね,きぶね
貴村	きむら,たかむら
貴田	きだ,たかだ,ときだ
貴島	きしま,きじま
鬼海	きうみ,きかい
鬼山	おにやま,きやま
鬼沢	おにさわ,おにざわ,きざわ
鬼追	おにさこ,きおい
鬼塚	おにずか,おにつか,おにづか
鬼柳	おにやなぎ,きやなぎ,きりゅう
鬼澤	おにさわ,おにざわ,きさわ
亀ヶ谷	かめがい,かめがや
亀海	かめうみ,かめがい
亀甲	かめこう,きこう,きっこう
亀崎	かめさき,かめざき
亀水	かめすい,かめみず
亀川	かめかわ,かめがわ
亀沢	かめさわ,かめざわ
亀谷	かめがい,かめたに,かめや
亀田	かめた,かめだ
亀島	かめしま,かめじま
亀頭	かめがしら,かめず
亀澤	かめさわ,かめざわ
儀賀	ぎか,ぎが
儀部	ぎぶ,ぎべ
宜寿次	ぎすし,ぎすじ
義積	よしずみ,よしづみ
義本	ぎもと,よしもと
菊崎	きくさき,きくざき
菊川	きくかわ,きくがわ
菊沢	きくさわ,きくざわ
菊谷	きくたに,きくや
菊地原	きくちはら,きくちばら
菊澤	きくさわ,きくざわ
吉	よし,よしざき
吉越	よしこし,よしごえ
吉家	きっか,よしいえ
吉賀	よしか,よしが
吉海	よしかい,よしがい
吉開	よしかい,よしがい
吉原	よしはら,よしわら
吉高	きったか,よしたか,よしだか
吉高神	きちこうじん,きっこうじん
吉崎	よしさき,よしざき
吉瀬	きせ,きちせ,きちぜ,よしせ
吉清	きたせい,きちせい
吉積	よしずみ,よしづみ
吉川	きちかわ,きっかわ,よしかわ
吉谷	よしがい,よしたに,よしや
吉津	きつ,よしず,よしつ,よしづ
吉田	よした,よしだ
吉島	きちじま,よしじま
吉嶋	きちじま,よしじま
吉藤	よしとう,よしふじ
吉迫	よしさこ,よしざこ
吉富	よしとみ,よしどみ
吉冨	よしとみ,よしどみ,よしどめ
吉敷	きしき,よしき
吉末	よしすえ,よしずえ
吉野谷	よしのたに,よしのや
吉友高	よしともこう,よしもとこう
吉留	よしとめ,よしどめ
吉澤	よしさわ,よしざわ
橘高	きったか,きつたか
橘川	きっかわ,きつかわ
橘田	きった,きつた,きつだ
橘木	すのき,たちばなき
杵島	きしま,きじま
杵淵	きねふち,きねぶち
逆井	さかい,さかさい
久	ひさ,ひさし
久々湊	くくみなと,くぐみなと,くにみなと
久下	くげ,ひさか
久家	くが,くげ
久我	くが,こが
久賀	くが,ひさが
久間	きゅうま,くま,ひさま
久間田	くまた,くまだ
久喜	きゅうき,くき
久郷	きゅうごう,くごう
久原	きゅうはら,くはら,くばる,ひさはら
久戸	きゅうと,ひさと
久後	くご,ひさご
久江	きゅうえ,ひさえ
久高	くだか,ひさたか
久佐賀	くさか,くさが
久崎	きゅうさき,きゅうざき,ひさざき
久山	くやま,ひさやま
久司	きゅうし,くし,ひさし
久次	きゅうじ,ひさつぐ
久守	くもり,ひさもり
久手堅	くてけん,くでけん
久住	くすみ,くずみ,ひさずみ
久住呂	くじゅうろ,くじゅろ
久重	ひさえ,ひさしげ
久世	くせ,くぜ
久瀬	きゅうせ,くせ,くぜ
久積	ひさずみ,ひさづみ
久川	きゅうかわ,ひさかわ
久蔵	きゅうぞう,ひさくら
久村	くむら,ひさむら
久地岡	くちおか,くぢおか
久津	くず,くつ,ひさつ
久田	くた,くだ,ひさた,ひさだ
久島	きゅうしま,くしま,ひさしま,ひさじま
久嶋	きゅうしま,くしま,ひさじま
久藤	くどう,ひさふじ
久徳	きゅうとく,ひさとく
久富	くとみ,くどみ,ひさとみ
久冨	ひさとみ,ひさどみ
久布白	くぶしろ,くぼしろ
久米川	くめかわ,くめがわ
久米田	くめた,くめだ
久保寺	くぼてら,くぼでら
久保谷	くぼたに,くぼや
久保島	くぼしま,くぼじま
久芳	くば,くぼ
久堀	くぼり,ひさぼり
久満	くま,ひさみつ
久木	きゅうき,くき,ひさき
久木野	くきの,くぎの
久門	きゅうもん,くもん,ひさかど
久野	きゅうの,くの,ひさの
久利	くり,ひさり
久留	くとめ,くる,ひさとめ,ひさどめ
久良	きゅうら,くろう
久良木	きゅうらぎ,くらき
久和	きゅうわ,くわ,ひさわ
休場	きゅうば,やすば,やすみば,やすんば
宮宇地	みやうち,みやうぢ
宮永	みやなか,みやなが
宮越	みやこし,みやごえ,みやごし
宮廻	みやさこ,みやまわり
宮原	みやはら,みやばら
宮戸	みやと,みやど
宮後	みやご,みやじり
宮向	みやむかい,みやむき,みやむこ
宮国	みやくに,みやぐに
宮腰	みやこし,みやごし
宮阪	みやさか,みやざか
宮崎	みやさき,みやざき
宮司	みやし,みやじ
宮上	みやうえ,みやかみ,みやがみ
宮城	みやき,みやぎ,みやしろ,みやんじょう
宮川	みやかわ,みやがわ
宮前	みやさき,みやざき,みやまえ
宮代	みやしろ,みやだい
宮沢	みやさわ,みやざわ
宮谷	みやがい,みやたに
宮谷内	みやうち,みやたにうち
宮地	みやじ,みやち,みやぢ
宮津	みやつ,みやづ
宮塚	みやつか,みやづか
宮田	みやた,みやだ
宮島	みやしま,みやじま
宮東	くとう,くどう,みやとう,みやひがし
宮藤	くどう,みやふじ
宮道	みやじ,みやみち
宮迫	みやさこ,みやざこ
宮保	みやほ,みやぼ
宮里	みやさと,みやざと
宮良	みやよし,みやら
宮國	みやくに,みやぐに
宮嶌	みやしま,みやじま
宮澤	みやさわ,みやざわ
弓崎	ゆみさき,ゆみざき
弓狩	ゆかり,ゆがり
弓場	ゆうば,ゆば,ゆみば
弓達	ゆだて,ゆみだて
弓谷	ゆみたに,ゆみや
弓納持	ゆなもち,ゆみなもち
弓部	ゆみべ,ゆんべ
弓野	きゅうの,ゆみの
弓立	ゆだて,ゆみたて
朽木	くちき,くつき
牛草	うしくさ,うしぐさ
牛塚	うしつか,うしづか
牛堂	うしどう,ごどう
牛尿	うしばり,うばり
牛尾	うしお,うじお
牛房	うしふさ,ごぼう
居城	いしろ,いじろ
居神	いかみ,いがみ
居石	いいし,いせき,おりいし,すえいし
巨海	おおみ,こみ
許士	きょし,きよし
許田	きょだ,もとだ
漁	あさり,いさり,すなどり,りょう
魚崎	うおさき,うおざき
魚谷	うおたに,うおや
魚津	うおず,うおつ,うおづ
魚返	うがえり,おがえり
魚躬	うおのみ,うおみ,さく
京	かなどめ,きょう
京角	きょうかく,きょうがく,きょうずみ
京増	きょうそう,きょうます
京谷	きょうたに,きょうや
京田	きょうた,きょうだ,きょうでん
京都	きょうと,みやこ
京馬	けば,けま
競	きそ,きそう
強瀬	こわせ,つよせ
橋岡	はしおか,はしをか
橋詰	はしずめ,はしづめ
橋戸	はしと,はしど
橋上	はしかみ,はしがみ
橋新	はししん,はしに
橋谷	はしたに,はしや
橋端	はしば,はしばた
橋塚	はしずか,はしづか
橋爪	はしずめ,はしづめ
橋都	はしずめ,はしづ,はしづめ
狭間	はさま,はざま
興地	おきじ,おきぢ
興野	おきの,きょうの
興梠	こうろ,こうろき,こうろぎ,こおろぎ
郷右近	ごううこん,ごうこん
郷司	ごうし,ごうじ
郷津	ごうず,ごうづ
郷田	ごうた,ごうだ,ごうでん
饗場	あいば,あえば
饗庭	あいば,あえば
仰木	おうぎ,おおぎ
暁	あかつき,ぎょう
曲山	きょくやま,まがりやま
曲師	まぎし,まげし
曲谷	まがたに,まがりや
曲田	まがた,まがりた,まがりだ
曲淵	まがりふち,まがりぶち
曲渕	かねぶち,まがりぶち
玉越	たまこし,たまごし
玉寄	たまよせ,たまより
玉懸	たまかけ,たまがけ
玉崎	たまさき,たまざき
玉作	たまさく,たまつくり
玉上	たまうえ,たまがみ
玉城	たまき,たまぐすく,たましろ
玉生	たまお,たまき,たまにう,たまにゅう,たもう
玉川	たまかわ,たまがわ
玉泉	ぎょくせん,たまいずみ
玉谷	たまたに,たまや
玉地	たまじ,たまち
玉置	たまおき,たまき
玉田	たまた,たまだ
桐生	きりう,きりゅう
桐谷	きりがや,きりたに,きりや
桐木	きりき,きりのき
錦見	にしきみ,にしみ
錦織	にしきおり,にしこうり,にしこおり,にしこり,にしごり
錦川	にしきかわ,にしきがわ
琴寄	ことよせ,ことより
近	こん,ちか
近江	おうみ,おおみ
近江屋	おうみや,おおみや
近江谷	おうみや,おおみや
近沢	ちかさわ,ちかざわ
近谷	こんたに,ちかたに,ちかや
近田	こんた,こんだ,ちかた,ちかだ
近内	こんない,ちかうち
近木	こぎ,ちかき
近野	こんの,ちかの
近澤	ちかさわ,ちかざわ
金	かね,きん,こん
金井	かない,かねい
金井塚	かないずか,かないづか
金岡	かなおか,かねおか
金屋	かなや,かねや
金海	かなうみ,かねうみ
金垣	かながき,かねがき
金巻	かなまき,かねまき
金関	かなせき,かねせき
金丸	かなまる,かねまる
金吉	かなきち,かねよし
金久保	かなくぼ,かねくぼ
金見	かなみ,かねみ
金原	かなはら,かねはら,きんばら,きんぱら
金戸	かなど,かねと
金光	かなみつ,かねみつ,こんこう
金口	かなくち,かなぐち,かねぐち
金行	かなゆき,かねゆき
金高	かねたか,きんたか
金坂	かなさか,かねさか
金崎	かなさき,かなざき,かねざき
金作	かなさく,かねさく
金山	かなやま,かねやま
金刺	かなざし,かねさし,かねざし
金指	かなさし,かなざし
金枝	かなえだ,かねえだ
金氏	かなうじ,かねうじ
金治	かなじ,かねじ
金重	かなしげ,かねしげ
金出	かないで,かなで
金春	こんばる,こんぱる
金松	かなまつ,かねまつ
金上	かながみ,かねじょう
金城	かなしろ,かねしろ,きんじょう
金場	かねば,こんば
金森	かなもり,かねもり
金親	かなおや,かねおや,かねちか
金須	かなす,きんす
金瀬	かなせ,かねせ
金成	かなり,かねなり,かんなり
金政	かなまさ,かねまさ
金正	かねまさ,きんしょう
金生	かなお,かねき,かのう
金石	かないし,かねいし
金川	かながわ,かねかわ,かねがわ
金村	かなむら,かねむら
金替	かねがい,かねがえ,きんたい
金代	かなしろ,かねしろ,きんだい
金谷	かなたに,かなだに,かなや,かねたに,かねや,きんや
金地	かなじ,かなち
金築	かなつき,かねつき
金中	かなか,かねなか
金津	かなつ,かなづ
金塚	かなつか,かなづか,かねづか,きんづか
金辻	かなつじ,きんつじ
金田	かなた,かなだ,かねた,かねだ,きんだ
金田一	きんたいち,きんだいち
金島	かなしま,かねしま
金藤	かねとう,かねふじ,きんとう,きんどう,こんどう
金堂	かなどう,こんどう
金内	かなうち,かねうち
金納	かんのう,きんのう
金馬	きんば,きんま,こんま
金尾	かなお,かねお
金浜	かなはま,かねはま
金武	かねたけ,きん
金武川	きんかわ,きんがわ
金平	かなひら,かねひら
金保	かなほ,かねやす
金堀	かなほり,かねほり
金本	かなもと,かねもと
金木	かなき,かねき
金野	かねの,きんの,こんの
金林	かなばやし,かねばやし,きんばやし
金脇	かなわき,かねわき
金澤	かなざわ,かねざわ
金萬	きんまん,こんまん
金藏	かねくら,こんぞう
銀川	ぎんかわ,ぎんがわ
九津見	くつみ,くづみ
九島	くしま,くじま
九嶋	くしま,くじま
九里	くのり,くり
駒崎	こまさき,こまざき
駒谷	こまたに,こまや
駒塚	こまつか,こまづか
具志堅	ぐしかた,ぐしけん
具島	ぐしま,ぐじま
空井	うつい,そらい
空閑	くうが,くが
空地	そらじ,そらち
隅山	すみやま,すやま
隅谷	すみたに,すみや
隅田	すだ,すみた,すみだ
串田	くした,くしだ
櫛田	くした,くしだ
窪寺	くぼてら,くぼでら
窪谷	くぼたに,くぼのや,くぼや
熊﨑	くまさき,くまざき
熊崎	くまさき,くまざき
熊取谷	いすたに,くまとりや
熊手	くまだいら,くまて,くまで
熊切	くまきり,くまぎり
熊川	くまかわ,くまがわ
熊谷	くまかや,くまがい,くまがえ,くまたに
熊田	くまた,くまだ
熊田原	くまたはら,くまたばら
熊木	くまき,くまぎ
隈崎	くまさき,くまざき
隈川	くまかわ,くまがわ
粂川	くめかわ,くめがわ
粂谷	くめがい,くめたに,くめや
粂田	くめた,くめだ
栗花落	つゆ,つゆり
栗原	くりはら,くりばら
栗崎	くりさき,くりざき
栗栖	くりす,くるす
栗生	くりう,くりゅう
栗飯原	くりいいはら,くりいいばら
繰上	くりかみ,くりがみ
繰生	くりう,くりゅう
桑原	くわはら,くわばら
桑崎	くわさき,くわざき
桑水流	くわずる,くわづる
桑折	くわおり,こおり
桑鶴	くわつる,くわづる
桑田	くわた,くわだ
桑島	くわしま,くわじま
桑嶋	くわしま,くわじま
桑波田	くわはた,くわばた
桑畑	くわはた,くわばた
桑澤	くわさわ,くわざわ
君塚	きみずか,きみづか
君ヶ袋	きみがふくろ,きみがぶくろ
君塚	きみつか,きみづか
君島	きみしま,きみじま
君嶋	きみしま,きみじま
訓覇	くらは,くるべ
軍地	ぐんじ,ぐんち
郡	こうり,こおり
郡家	ぐんけ,ぐんげ
郡司	ぐんし,ぐんじ
郡司掛	ぐんじかけ,ぐんじがけ
郡田	ぐんだ,こおりた
刑部	おさかべ,おさべ,きょうぶ,ぎょうぶ
形部	かたべ,ぎょうぶ
恵下	えげ,えした
恵谷	えたに,えや
慶越	けいごえ,けいごし
慶田城	けたしろ,けだしろ
慶田盛	けたもり,けだもり
桂川	かつらかわ,かつらがわ
畦	あぜ,うね
畦原	あぜはら,うねはら
畦田	あぜた,うねた,うねだ
経塚	きょうずか,きょうづか,つねつか
経田	きょうだ,きょうでん,つねだ
計良	けいら,けら
鶏冠井	かいで,かいでん,かえで
迎	むかい,むかえ
穴原	あなはら,あなばら
穴蔵	あなくら,あなぐら
穴太	あなお,あの
月居	つきい,つきおり
月光	がっこう,つきみつ
月川	つきかわ,つきがわ
月足	つきあし,つきたり
月田	つきた,つきだ
月東	がっとう,げっとう
月野木	つきのき,つきのぎ
月輪	つきのわ,つきわ
月澤	つきさわ,つきざわ
兼次	かねし,かねつぐ
兼城	かねき,かねしろ
兼田	かねた,かねだ
兼島	かねしま,かねじま
剣持	けんもち,けんもつ
堅田	かたた,かただ
建田	たけだ,たてだ
建部	たけべ,たてべ
懸高	かけたか,かけだか
懸田	かけた,かけだ
権瓶	ごんべい,ごんぺい
犬塚	いぬつか,いぬづか
犬飼	いぬかい,いぬがい
犬塚	いぬずか,いぬつか,いぬづか
犬島	いぬしま,いぬじま
犬嶋	いぬしま,いぬじま
犬童	いぬどう,いんどう,けんどう
犬伏	いぬぶし,いぬぶせ
絹川	きぬかわ,きぬがわ
絹谷	きぬたに,きぬや
見月	みつき,みづき
見坂	けんざか,みさか
見寺	みてら,みでら
見上	けんじょう,みかみ
見田	けんだ,みた
見藤	けんとう,けんどう,みとう
見明	けんみょう,みあけ
見野	けんの,みの
鍵谷	かぎたに,かぎや
顕谷	あらたに,あらや
元	げん,はじめ,もと
元安	みとやす,もとやす
元家	もといえ,もとや
元沢	もとさわ,もとざわ
元谷	もとたに,もとや
元地	もとじ,もとち
元智	げんち,もとち
元島	もとしま,もとじま
元木	もとき,もとぎ
原崎	はらさき,はらざき
原谷	はらたに,はらや
原田	はらた,はらだ
原島	はらしま,はらじま
原嶋	はらしま,はらじま
原之園	はらのその,はるのその
原國	はらくに,はらぐに
原澤	はらさわ,はらざわ
源	げん,みなもと
源河	げんか,げんかわ,げんが
源川	げんかわ,げんがわ,みながわ
源島	げじま,げんじま
玄永	くろなが,げんえい
現王園	げんおぞの,げんのうぞの
古宇田	こうた,こうだ
古曳	こひき,こびき,ふるびき
古屋	こや,ふるや
古屋敷	こやしき,ふるやしき
古家	こいえ,こうけ,こが,こや,ふるいえ,ふるえ,ふるけ,ふるや
古河	こが,ふるかわ
古海	ふるうみ,ふるみ
古垣内	こがいと,ふるがいち
古角	こかど,こすみ,ふるかど
古閑	こかん,こが
古館	こだて,ふるたち,ふるたて,ふるだて
古舘	ふるたち,ふるたて,ふるだち,ふるだて
古久根	こくね,こぐね
古久保	こくぼ,ふるくぼ
古宮	こみや,ふるみや
古郷	こごう,ふるごう
古玉	こだま,ふるたま
古金	こがね,ふるがね
古熊	こくま,ふるくま
古郡	ふるこおり,ふるごうり,ふるごおり
古結	こけつ,こげつ
古月	ふうげつ,ふるづき
古堅	ふるかた,ふるげん
古見	こみ,ふるみ
古元	こもと,ふるもと
古原	こはら,こばら,ふるはら
古口	こぐち,ふるくち,ふるぐち
古坂	こさか,ふるさか
古崎	こさき,ふるさき
古山	こやま,ふるやま
古寺	こてら,こでら
古謝	こしゃ,こじゃ
古守	こもり,ふるもり
古勝	こがち,ふるかつ
古小路	こしょうじ,ふるこうじ
古庄	こしょう,ふるしょう
古松	こまつ,ふるまつ
古城	こぎ,こしろ,こじょう,ふるき,ふるしろ,ふるじょう
古森	こもり,ふるもり
古水	こすい,ふるみず
古瀬	こせ,ふるせ
古性	こしょう,ふるしょう
古西	こにし,ふるにし
古石	こせき,ふるいし
古積	こせき,こづみ
古川	こがわ,ふるかわ
古泉	こいずみ,こいづみ
古荘	こそう,ふるしょう
古村	こむら,ふるむら
古代	こしろ,こだい,ふるしろ
古沢	こざわ,ふるさわ,ふるざわ
古谷	こさく,こたに,こや,ふるたに,ふるや
古地	こじ,ふるち
古池	こいけ,ふるいけ
古仲	こなか,ふるなか
古津	こづ,ふるつ
古田	こだ,ふるた
古田土	こたと,こだと
古田島	こたじま,こだじま
古都	ふるいち,ふるつ
古島	こじま,ふるしま
古嶋	こしま,こじま,ふるしま
古東	ことう,こひがし
古藤	ことう,こどう,ふるどう
古道	こどう,ふるみち
古内	こうち,ふるうち
古波蔵	こはぐら,こばくら
古畑	こはた,こばた,ふるはた
古浜	こはま,ふるはま
古府	ふるこ,ふるふ
古武	こたけ,ふるたけ
古牧	こまき,ふるまき
古本	こもと,ふるもと
古俣	こまた,ふるまた
古満	こまん,ふるみつ
古明地	こめいじ,こめいち,こめじ,こめぢ
古木	こき,こぎ,ふるき
古門	ふるかど,ふると
古野	この,ふるの
古林	こばやし,ふるばやし
古澤	こさわ,ふるさわ,ふるざわ
呼子	よびこ,よぶこ
戸﨑	とさき,とざき
戸ノ崎	とのさき,とのざき
戸井	とい,どい
戸井田	といた,といだ
戸叶	とかの,とかのう,とがの,とがのう
戸崎	とさき,とざき
戸次	とつぎ,へつぎ,べっき,べつき,べつぎ
戸出	といで,とで
戸上	とかみ,とがみ
戸谷	とたに,とだに,とや
戸津	とつ,とづ
戸津川	とつかわ,とつがわ
戸塚	とつか,とづか
戸島	としま,とじま
戸嶋	としま,とじま
戸矢崎	とやさき,とやざき
戸来	とき,へらい
湖城	こぐすく,こしろ,こじょう
狐崎	きつねざき,こざき
狐塚	きつねづか,こづか
袴塚	はかまつか,はかまづか
袴田	はかまた,はかまだ
胡桃沢	くるみさわ,くるみざわ
胡桃澤	くるみさわ,くるみざわ
虎谷	とらたに,とらや
五熊	いつくま,ごくま
五月女	さおとめ,そうとめ,そおとめ,そとめ
五十井	いおい,いかい,いそい
五十君	いぎみ,いそぎみ
五十公野	いじみの,いずみの
五十子	いかご,いがっこ,いそこ
五十棲	いおずみ,いそずみ
五十川	いかがわ,いずがわ,いそかわ,いそがわ
五十殿	おみか,おむか
五十田	いかだ,いそだ
五十島	いがしま,いそしま
五十畑	いかはた,いそはた
五十嵐	いからし,いがらし
五十里	いかり,いそり
五島	いつしま,ごしま,ごじま,ごとう
五嶋	ごしま,ごとう
五百旗頭	いおきと,いおきべ
五百川	いおかわ,いおがわ,いもかわ,いよかわ
五百蔵	いおくら,いおろい
五本	いつもと,ごほん
五木田	ごきた,ごきだ
五林	ごばやし,ごりん
五老海	いさみ,ごろうかい
伍井	いつい,ごい
伍賀	ごか,ごが
呉	くれ,ご
呉屋	くれや,ごや
呉田	くれた,くれだ
吾妻	あがつま,あずま,あづま
後岡	うしろおか,のちおか
後原	あとはら,せどはら
後口	あとぐち,うしろぐち
後山	あとやま,うしろやま,のちやま
後出	あといで,のちいで
後小路	うしろこうじ,うしろしょうじ
後上	あとがみ,ごかみ,ごがみ
後神	あとがみ,ごこう
後川	うしろかわ,うしろがわ
後沢	うしろざわ,のちざわ
後谷	ごうたに,ごしたに,ごたに
後田	うしろだ,ごだ,のちだ
後迫	うしろさこ,うしろざこ
後野	あとの,うしろの,ごうの,ごの,のちの
御園生	みそのう,みそのお
御器谷	ごきたに,みきや
御子	おこ,みこ
御宿	みしく,みしゅく
御前	おんまえ,みさき
御代田	みよた,みよだ
御池	おいけ,みいけ
御調	おしらべ,みつぎ
御幡	おばた,みはた
御輿	おこし,おごし,おんこし
悟道	ごとう,ごどう
鯉田	こいた,こいだ
光延	こうのべ,みつのぶ,みつのぷ,みつのべ
光家	みついえ,みつや
光崎	こうざき,みつざき
光谷	みつたに,みつや
光田	こうだ,みった,みつた,みつだ
光島	こうじま,みつしま
光藤	みつどう,みつふじ
光畑	こうはた,みつはた
光富	こうとみ,みつとみ
光部	こうべ,みつべ
光本	こうもと,みつもと
光明	こうみょう,こうめい
光木	みつき,みつぎ
光野	こうの,みつの
公家	くげ,こうけ
公門	きみかど,くもん,こうもん
功力	くぬぎ,くのぎ
厚	あつ,あつし
厚井	あつい,こうい
厚海	あつうみ,あつみ
厚治	あつじ,あつぢ
厚地	あつじ,あつち,あつぢ
厚東	こうとう,ことう
厚朴	ほうのき,ほのき
厚木	あつき,あつぎ,ほおのき
口分田	くぶんでん,くもだ,くもで
向	むかい,むこう
向井	むかい,むこうがわ
向原	むかいはら,むこうはら
向坂	こうさか,さきさか,むこうざか
向阪	こうさか,さきさか
向山	さきやま,むかいやま,むこうやま,むこやま
向柴	むこうしば,むこしば
向所	むかいしょ,むかいじょ
向上	こうじょう,むかうえ
向川	むかいがわ,むこうがわ,むこがわ
向谷	むかいたに,むかいだに,むこたに
向田	こおだ,むかいだ,むかた,むかだ,むこうだ
向島	むこうしま,むこうじま
向峠	むかいとうげ,むかとうげ
向日	むかい,むかひ
向畑	むかいはた,むかいはたけ,むこうばた
向畠	むこうはた,むこばた
向平	むかいひら,むこうひら
向本	むかいもと,むかもと
向野	こうの,むかいの,むくの
好川	こがわ,よしかわ,よしひさ
好田	こうだ,よしだ
孝橋	こうはし,たかはし
工藤	くとう,くどう
幸	こう,さいわい,みゆき,ゆき
幸崎	こうさき,こうざき
幸松	こうまつ,ゆきまつ
幸正	こうしょう,こうせい
幸泉	こいずみ,こういずみ
幸前	こうぜん,こうまえ
幸村	こうむら,ゆきむら
幸谷	こうたに,こうや
幸田	こうた,こうだ,ゆきた
幸島	こうしま,こうじま,さしま
幸保	こうほ,こうぼ
幸本	こうもと,ゆきもと
幸野	こうの,ゆきの
幸林	こうばやし,こうりん
幸澤	こうさわ,ゆきざわ
広海	ひろうみ,ひろみ
広谷	ひろたに,ひろや
広長	ひろちょう,ひろなが
広内	ひろうち,ひろない
広本	こうもと,ひろもと
康	こう,やす
弘原海	わだつみ,わだづみ
弘世	くぜ,ひろせ
恒藤	つねとう,つねふじ
恒富	つねとみ,つねどみ
更家	さらいえ,さらや
更田	ふけた,ふけだ
校條	こうじょう,めんじょう
構	かまい,かまえ
江	こう,ごう
江﨑	えさき,えざき
江夏	えなつ,こうか
江角	えすみ,えずみ
江橋	えはし,えばし
江月	えづき,こうげつ
江原	えはら,えばら
江戸	えと,えど
江坂	えさか,えざか
江崎	えさき,えざき
江刺家	えさしか,えさしや
江泉	えいずみ,えずみ
江田	えた,えだ,こうだ
江渡	えと,えど
江島	えしま,えじま
江頭	えがしら,えとう
江畠	えはた,えばた
江木	えき,えぎ
江利川	えりかわ,えりがわ
江里	えざと,えり
江連	えずれ,えづら,えづれ
江澤	えさわ,えざわ
江籠	えご,えごう
溝口	みぞくち,みぞぐち
溝上	こうがみ,みぞうえ,みぞかみ,みぞがみ
溝川	みぞかわ,みぞがわ
溝端	みぞはた,みぞばた
溝渕	みぞふち,みぞぶち
甲	かぶと,きのえ
甲原	きねはら,こうはら
甲山	こうざん,こうやま
甲谷	かうたに,かぶとや,こうたに,こうや
甲地	かっち,こうち
甲津	こうず,こうづ
甲田	こうた,こうだ
甲藤	かっとう,かつとう,こうどう
甲畑	こうはた,こうばた
甲府方	こうふかた,こうふがた
糠野	こうの,ぬかの
紅谷	べにたに,べにや
紅野	こうの,べにの
紅露	こうろ,こおろ
綱河	つなかわ,つながわ
綱川	つなかわ,つながわ
綱島	あみしま,つなしま
綱野	あみの,つなの
荒	あら,あらおか
荒関	あらせき,あらぜき
荒舘	あらたて,あらだち
荒金	あらかね,あらがね
荒城	あらき,あらしろ
荒生	あらお,あろう
荒谷	あらたに,あらや
荒殿	あらとの,あらどの
荒砥	あらこ,あらと
荒内	あらうち,あらない
荒能	あらの,あらのう
荒幡	あらはた,あらはん
荒堀	あらほり,あらぼり
行吉	ゆきよし,ゆくよし
行川	あゆかわ,なめかわ
行谷	なめがや,ゆきや
行田	ぎょうた,ぎょうだ,こうだ,なめた,なめだ,ゆきた,ゆきだ
行武	ゆきたけ,ゆくたけ
行方	なめかた,ゆきかた
行本	ゆきもと,ゆくもと
行木	なみき,なめき,ゆうき
行友	ゆきとも,ゆくとも
行澤	ゆきさわ,ゆきざわ
降屋	ふりや,ふるや
降旗	ふりはた,ふるはた
降幡	ふりはた,ふるはた
降矢	ふりや,ふるや
香月	かずき,かつき,かづき,こうつき
香原	かはら,こうはら
香山	かやま,こうやま
香取	かとり,かんどり
香城	かしろ,こうじょう
香西	かさい,かにし,こうさい,こうざい
香村	かむら,こうむら
香林	こうばやし,こうりん
高	こう,たか,たかし
高羽	たかは,たかば
高遠	たかと,たかとう,たかとお
高岡	こうおか,たかおか
高屋	こうや,たかや
高下	こうげ,たかした
高家	たかけ,たかや
高階	たかしな,たかはし
高舘	たかだち,たかだて
高久	たかきゅう,たかく,たかひさ
高玉	たかたま,たかだま
高月	こうずき,たかつき
高見沢	たかみさわ,たかみざわ
高見澤	たかみさわ,たかみざわ
高原	こうばら,たかはら
高戸	たかと,たかど
高口	こうぐち,たかくち,たかぐち
高向	たかむき,たかむく
高江洲	たかえす,たかすえ
高佐	こうさ,たかさ
高砂	たかさご,たかすな
高坂	こうさか,たかさか
高崎	たかさき,たかざき
高山	こうやま,たかやま
高寺	たかてら,たかでら
高鹿	こうろく,たかしか
高出	たかいで,たかで
高上	たかうえ,たかがみ
高乗	こうじょう,たかじょう,たかのり
高城	たかき,たかぎ,たかしろ,たかじょう,たき
高須賀	たかすか,たかすが
高正	たかしょう,たかまさ
高僧	こうそう,たかそ,たかそう
高草木	たかくさき,たかくさぎ
高村	こうむら,たかむら
高沢	たかさわ,たかざわ
高谷	こうや,たかたに,たかたや,たかや
高地	こうち,たかち
高智	こうち,たかち
高津	こうず,こうつ,こうづ,たかつ
高塚	こうつか,たかつか
高田	たかた,たかだ
高筒	たかづつ,たかとう
高藤	たかとう,たかふじ
高道	たかどう,たかみち
高納	たかの,たかのう
高畑	たかはた,たかばたけ
高畠	たかはた,たかばたけ
高樋	たかどい,たかひ
高堀	たかほり,たかぼり
高本	こうもと,たかもと
高味	こうみ,たかみ
高木	たかき,たかぎ
高野	こうの,こうや,たかの
高野瀬	こうのせ,たかのせ
高野辺	こうのべ,たかのべ
高里	たかさと,たかざと
高良	こうら,たから
高力	こうりき,たかりき
高麗	こうま,こうらい,こま,たかま
高渕	たかふち,たかぶち
高澤	たかさわ,たかざわ
高邉	こうべ,たかべ
鴻	おおとり,ひしゃご
鴻海	こうのうみ,こうのみ
鴻上	こうかみ,こうがみ
合羽井	かっぱい,かわい
合月	あいつき,あいづき
合原	あいはら,あいばら,ごうはら
合戸	あいと,あいど,ごうと
合志	こうし,ごうし
合瀬	おうせ,おおせ
合沢	あいさわ,あいざわ
合谷	あいたに,ごうたに,ごうや
合津	あいづ,ごうず,ごうつ,ごうづ
合田	あいだ,ごうだ,ごおだ
合島	あいじま,ごうじま
合木	あいき,ごうき
合野	あいの,ごうの
合六	あいろく,ごうろく
合澤	あいさわ,あいざわ
国司	くにし,こくし
国上	くにかみ,くにがみ
国場	くにば,こくば
国沢	くにさわ,くにざわ
国田	くにた,くにだ
国東	くにさき,くにとう
国藤	くにとう,くにふじ
国頭	くにがみ,くにとう
国府	こお,こくふ,こくぶ
国府田	こうだ,こくふた,こくふだ
国府方	こくふかた,こくふがた,こくぶがた
国分	くにわけ,こくふ,こくぶ,こくぶん
国保	こくほ,こくぼ
国立	くにたて,こくりゅう
国澤	くにさわ,くにざわ
黒羽	くろは,くろはね,くろば,くろばね
黒羽根	くろはね,くろばね
黒越	くろこし,くろごし
黒河	くろかわ,くろこう
黒河内	くろこうち,くろごうち
黒葛原	つづらはら,つづらばら
黒子	くろこ,くろす
黒住	くろすみ,くろずみ
黒谷	くろたに,こくたに
黒地	くろじ,くろち
黒田	くろた,くろだ
黒淵	くろふち,くろぶち
黒米	くろごめ,くろよね
黒木	くろき,くろぎ
腰塚	こしつか,こしづか
今	いま,こん
今園	いまその,いまぞの
今関	いませき,いまぜき
今給黎	いまきいれ,いまきゅうれい,いまぎれ
今駒	いまこま,こんま
今戸	いまと,いまど
今崎	いまさき,いまざき
今宿	いましゅく,いまじゅく
今出	いまいで,いまで
今庄	いましょう,いまじょう
今上	いまうえ,いまじょう
今城	いまき,いまぎ,いましろ,いまじょう
今川	いまかわ,いまがわ
今多	いまた,いまだ
今地	いまじ,いまち
今長	いまちょう,いまなが
今津	いまず,いまづ
今田	いまだ,こんた,こんだ
今島	いましま,いまじま
今藤	いまふじ,こんどう
今堀	いまほり,いまぼり
今野	いまの,こんの
今来	いまき,こんらい
今里	いまさと,いまざと
今立	いまだち,いまだて
今林	いまはやし,いまばやし
今澤	いまさわ,いまざわ
根井	ねい,ねのい
根角	ねかど,ねすみ
根橋	ねはし,ねばし
根建	ねたて,ねだち
根崎	ねさき,ねざき
根上	ねあがり,ねがみ
根占	ねじま,ねじめ
根津	ねず,ねつ,ねづ
根田	こんだ,ねだ
根武谷	たなかだて,ねぶや
根保	こんぼ,ねほ
根木	ねき,ねぎ
根立	ねだち,ねだて
紺谷	こんたに,こんや
紺田	こんた,こんだ
佐々	ささ,さっさ
佐々生	ささお,ささき
佐々布	ささふ,さそう
佐久	さきゅう,さく
佐久田	さくた,さくだ
佐橋	さはし,さばせ
佐原	さはら,さわら
佐古田	さこた,さこだ
佐次田	さしだ,さじた,さじだ
佐治	さじ,さぢ
佐鹿	さしか,さじか
佐神	さがみ,さこう
佐瀬	させ,さぜ
佐生	さしょう,さそう
佐草	さくさ,さそう
佐谷	さたに,さや
佐地	さじ,さち,さぢ
佐長	さいき,さなが
佐塚	さつか,さづか
佐田	さた,さだ
佐渡	さど,さわたり
佐怒賀	さぬか,さぬが
佐島	さしま,さじま
佐波	さなみ,さば
佐伯	さいき,さえき,さへき
佐美三	さみそう,さみぞう
佐分	さぶり,さわけ
佐方	さかた,さがた
佐柳	さなぎ,さやなぎ
佐立	さたて,さだち,さだて
嵯峨井	さがい,さがのい
左右田	さうだ,さゆうだ,そうだ,そおだ
左近允	さこんじゅ,さこんじゅう,さこんじょう
左高	さたか,さだか
左尾	さお,さび
差波	さしなみ,さみなみ
沙魚川	はせがわ,はぜかわ
砂岡	いさおか,すなおか
砂金	いさご,すながね
砂子	すなこ,すなご
砂子田	いさごだ,すなこた,すなこだ,すなごた,すなごだ
砂生	さそう,すなう
砂川	いさがわ,すなかわ,すながわ
砂塚	すなずか,すなづか
砂田	すなた,すなだ
砂渡	さわたり,すなわたり
砂野	いさの,すなの
座主坊	ざしぼ,ざしぼう,ざしゅぼう
最相	さいしょう,さいそう
妻鹿	つましか,めが
妻神	さいかみ,さいがみ,さいのかみ
妻鳥	つまどり,めんどり
妻木	つまき,つまぎ
才原	さいはら,さいばら
才崎	さいさき,さいざき
才田	さいた,さいだ
斎	いつき,さい,とき
斎賀	さいか,さいが
斎田	さいた,さいだ
細越	ほそこし,ほそごえ
細貝	ほそかい,ほそがい
細谷	ほそたに,ほそだに,ほそや
細美	さいみ,ほそみ
細木	ほそき,ほそぎ
在家	ざいか,ざいけ
在原	あいはら,ありはら
在川	ありかわ,ざいかわ
在塚	ありつか,ありづか
材木	ざいき,ざいもく
坂	さか,ばん
坂詰	さかつめ,さかづめ
坂戸	さかと,さかど
坂根	さかね,さがね
坂上	さかうえ,さかがみ,さかじょう,さかのうえ
坂西	さかにし,ばんざい
坂谷	さかたに,さかだに,さかや
坂地	さかじ,さかち
坂爪	さかつめ,さかづめ
坂内	さかうち,ばんない
坂野	さかの,ばんの
坂齊	さかさい,ばんさい
阪	さか,ばん
阪上	さかうえ,さかがみ,さかのうえ
阪西	さかにし,ばんざい
阪谷	さかたに,さかや
阪田	さかた,はんだ
阪野	さかの,ばんの
堺谷	さかいたに,さかいだに,さかいや
榊原	さかきはら,さかきばら
榊谷	さかきたに,さかきや
榊田	さかきた,さかきだ
咲花	さきはな,さくはな
咲間	さきま,さくま
崎向	さきむかい,さきむき
崎谷	さきたに,さきや
崎田	さきた,さきだ
鷺谷	さぎたに,さぎのや,さぎや
作田	さくた,さくだ
作道	さくどう,さくみち,つくりみち
朔	さく,はじめ
柵木	ませき,ませぎ
桜谷	さくらたに,さくらや
笹	いいざさ,ささ
笹子	ささこ,ささご
笹生	ささお,さそう
笹川	ささかわ,ささがわ
笹谷	ささたに,ささや
笹津	ささつ,ささづ
笹路	ささじ,ささみち
薩田	さった,さつた
雑賀	さいか,さいが
鮫島	さめしま,さめじま
皿谷	さらたに,さらや
皿田	さらた,さらだ
三塚	みつか,みつつか,みつづか
三ケ田	みかた,みかだ,みけだ
三ッ口	みつくち,みつぐち
三ツ田	みつた,みつだ
三ツ木	みつき,みつぎ
三井	みい,みつい
三羽	さんぱ,みつわ,みわ
三岡	みおか,みつおか
三屋	さんや,みつや
三家	さんけ,みつや,みや
三箇	さんか,さんが
三角	みかど,みすみ
三間	ざんま,みつま,みま
三宮	さんぐう,さんのみや,さんみや,みみや
三橋	みつはし,みはし
三栗	みくり,みつくり
三戸	さんと,さんど,さんのへ,みと
三股	みつまた,みまた
三溝	さみぞ,みつみぞ
三坂	さんさか,みさか
三山	みつやま,みやま
三枝	さいくさ,さいぐさ,さえぐさ,みえ,みえだ,みつえだ
三枝木	さえき,みえき
三寺	みつでら,みてら
三次	みつぎ,みよし
三守	みかみ,みもり
三樹	みき,みつぎ
三重	みえ,みしげ
三小田	さんこだ,みこた,みこだ
三松	みつまつ,みまつ
三上	さんじょう,みかみ
三城	さんじょう,みしろ
三森	さんもり,みつもり,みもり
三厨	みくり,みくりや
三瀬	さんせ,みせ,みつせ
三成	みつなり,みなり
三川	さんかわ,みかわ
三箭	みつや,みや
三倉	さそう,みくら
三代	みしろ,みよ
三宅	みあけ,みやけ
三塚	みつか,みつつか,みつづか,みづか
三田	さんた,さんだ,みた
三登	さんと,さんとう,みと
三藤	みつふじ,みとう,みふじ
三日月	みかげ,みかづき
三波	さんなみ,みなみ
三反	さんたん,さんだん
三反園	さんたんぞの,みたぞの
三尾	みお,みつお
三瓶	さんべ,さんぺい,みかめ
三富	さんとみ,みとみ
三部	さんぶ,さんべ,みなべ,みべ
三分一	さんぶいち,みわけいち
三幣	さんぺい,みぬさ
三平	さんぺい,みひら
三並	みつなみ,みなみ
三辺	さんべ,みなべ
三歩一	さんぶいち,みほいち
三堀	みつほり,みつぼり,みほり
三本	みつもと,みもと
三本菅	さんぼんすが,さんぼんすげ
三摩	さんま,みま
三又	みつまた,みまた
三木	さんき,みき,みつぎ
三木谷	みきたに,みきや
三野	さんの,みつの,みの
三矢	みつや,みや
三留	みとめ,みる
三林	さんばやし,みつばやし,みばやし
三輪	さんわ,みわ
三輪田	みわた,みわだ
三簾	みす,みすい
三浪	さんなみ,みなみ
三和	みつわ,みわ
三潴	みつま,みづま
三觜	みつはし,みつばし,みはし
三邊	さんべ,みなべ
山﨑	やまさき,やまざき
山ノ口	やまのくち,やまのぐち
山井	やまい,やまのい
山羽	やまは,やまば
山越	やまこし,やまごえ,やまごし
山王	さんおう,さんのう
山音	やまおと,やまね
山家	やまいえ,やまが,やまや,やんべ
山角	やまかく,やまかど,やまずみ
山郷	さんごう,やまごう
山形	やまかた,やまがた
山肩	やまかた,やまがた
山口	やぐち,やまくち,やまぐち
山根木	やなねぎ,やまねき
山崎	やまさき,やまざき
山子	やまご,やまね
山鹿	やまが,やましか
山出	やまいで,やまで
山上	さんじょう,やまうえ,やまかみ,やまがみ,やまじょう
山神	やまかみ,やまがみ
山菅	やましげ,やますが,やますげ
山澄	やますみ,やまずみ
山岨	やまそ,やまそば
山沢	やまさわ,やまざわ
山谷	やまたに,やまや
山端	やまはし,やまはた,やまはな,やまばた,やまばな,やまべり
山地	やまじ,やまち,やまぢ
山東	さんとう,さんどう
山藤	さんとう,やまとう,やまふじ
山道	やまじ,やまみち
山内	やまうち,やまのうち
山之口	やまのくち,やまのぐち
山納	さんのう,やまのう
山平	やまだいら,やまひら
山辺	やまのべ,やまべ
山保	さんぽ,やまほ
山方	やまかた,やまがた
山門	やまかど,やまど
山里	やまさと,やまざと
山澤	やまさわ,やまざわ
山邉	やまのべ,やまべ
桟原	さじきはら,さじきばら
産賀	うぶか,うぶかた
四ッ谷	よつたに,よつや
四ツ谷	よつたに,よつや
四阿	あずま,あづま,しあ
四井	しい,よつい
四王天	しおうてん,しおうでん
四家	しが,しけ,よつや
四宮	しのみや,しみや
四谷	しだに,よつや
四津	よつ,よづ
四津谷	よつたに,よつや
四辻	よつじ,よつつじ
四方	しかた,しほ,しほう,よかた,よも
四方田	よもた,よもだ
四柳	しやなぎ,よつやなぎ
四條	しじょう,よじょう
姉崎	あねさき,あねざき
姉川	あねかわ,あねがわ
子浦	こうら,しお
子吉	こよし,ねよし
子川	こがわ,ねがわ
市古	いちこ,いちご
市戸	いちと,いちのへ
市山	いちやま,しやま
市場	いたいば,いちば
市瀬	いちせ,いちのせ
市田	いちた,いちだ
市島	いちしま,いちじま
市東	いちとう,しとう
志柿	しかき,しがき
志戸本	しともと,しどもと
志手	して,しで
志鷹	したか,しだか
志築	しずき,しちく,しづき
志津	しず,しづ
志津田	しつだ,しづた
志藤	しとう,しとお,しどう
志道	しじ,しどう
志波	しは,しば,しわ
志保井	しほい,しぼい
指崎	さしさき,しざき
枝川	えがわ,えだがわ
枝村	えだむら,まきむら
氏家	うじいえ,うじけ
氏兼	うじかな,うじかね
獅子内	ししうち,ししない
私市	きさいち,しいち
糸川	いとかわ,いとがわ
糸谷	いとたに,いとだに,いとや
糸田	いとた,いとだ
糸藤	いとう,いとふじ
糸毛	いとけ,いとげ
紙谷	かみたに,かみや
紫藤	しとう,しどう
飼牛	かいご,かいごう
似鳥	にたとり,にたどり,にとり
児戸	こうと,こと
児子	にこ,にご
寺家	じけ,てらいえ
寺垣内	てらがいと,てらがうち
寺原	てらはら,てらばる
寺戸	てらと,てらど
寺主	てらじ,てらぬし
寺川	てらかわ,てらがわ
寺沢	てらさわ,てらざわ
寺谷	てらたに,てらや
寺地	てらじ,てらち,てらぢ
寺中	じちゅう,てらなか
寺田	てらた,てらだ
寺島	てらしま,てらじま
寺嶋	てらしま,てらじま
寺分	てらぶん,てらわけ
寺平	てらだいら,てらひら
寺門	じもん,てらかど
寺澤	てらさわ,てらざわ
持舘	もちだて,もったて,もつたて
持地	もちじ,もちぢ
持木	もちき,もちぎ
持立	もちたて,もつたて
時崎	ときさき,ときざき
時沢	ときさわ,ときざわ
時谷	ときたに,ときや
時田	ときた,ときだ
時任	ときと,ときとう
次家	つぎいえ,つぐいえ
次郎垣内	じろうがいち,じろうがきうち
治田	じだ,はるた
治部	じぶ,じべ
治郎丸	じろうまる,じろまる
自見	じけん,じみ
蒔苗	まかない,まかなえ,まきなえ
鹿角	かつの,かづの
鹿戸	しかと,しかど
鹿江	かのえ,しかえ
鹿子	かのこ,しかご
鹿子生	かこう,かこお
鹿子木	かのこぎ,しかこぎ
鹿住	かすみ,かずみ
鹿川	かがわ,しかがわ
鹿田	しかた,しかだ
鹿島	かしま,かじま,ろくしま
鹿内	しかうち,しかない
鹿俣	かのたま,かのまた
鹿毛	かけ,かげ
鹿野	かの,しかの
鹿礒	かいそ,かのそ
式地	しきじ,しきち
式田	しきた,しきだ
竺	じく,ちく
宍戸	ししと,ししど
七海	ななうみ,ななみ
七宮	しちのみや,ななみや
七戸	しちのへ,ななと,ひちのへ
七五三木	しめき,しめぎ
七枝	ななえだ,ななつえ
七谷	しちたに,ななたに
七田	しちた,しちだ,ななた,ひつだ
七島	しちしま,ななしま
七里	しちり,ななさと
七寳	しっぽう,ななほう
室﨑	むろさき,むろざき
室崎	むろさき,むろざき
室谷	むろたに,むろや
室塚	むろつか,むろづか
室伏	むろふし,むろぶし,むろぶせ
室本	しつもと,むろもと
漆原	うるしはら,うるしばら
漆坂	うるしさか,うるしざか
漆川	うるしがわ,しつかわ
漆谷	うるしたに,うるしだに,うるしや
漆畑	うるしはた,うるしばた
実兼	さねかね,じつかね
実光	さねみつ,じっこう
実石	さねいし,じついし
実方	さねかた,じつかた
蔀	しとみ,しどみ
篠塚	しのつか,しのづか
篠遠	しのとう,しのとお
篠岡	ささおか,しのおか
篠崎	しのさき,しのざき
篠山	ささやま,しのやま
篠塚	しのずか,しのつか,しのづか
篠島	ささじま,しのじま
篠藤	しのとう,しのふじ
篠木	しのき,しのぎ
柴戸	しばこ,しばと
柴崎	しばさき,しばざき
柴谷	しばたに,しばや
柴内	しばうち,しばない
芝口	しばくち,しばぐち
芝地	しばじ,しばち
斜木	ななめき,ななめぎ
謝花	しゃばな,じゃはな
謝敷	しゃしき,しゃじき,じゃしき
車谷	くるまたに,くるまだに,くるまや
車田	くるまた,くるまだ,のりた
蛇川	じゃがわ,へびかわ
蛇田	へびた,へんだ
錫谷	すずたに,すずや
若園	わかその,わかぞの
若城	わかき,わかぎ,わかしろ
若生	わかいき,わかお,わこう,わこお
若谷	わかたに,わかや
若木	わかき,わかぎ
若澤	わかさわ,わかざわ
主原	しゅはら,すはら,ぬしはら
主藤	しゅとう,すとう,すどう
取違	とりい,とりちがい
守	まもり,もり
守家	もりか,もりや
守谷	もりたに,もりや
守田	まもりた,もりた
手塚	てずか,てづか
手崎	てさき,てざき
手取	てとり,てどり
手束	てつか,てづか
手塚	てずか,てつか,てづか
手島	てしま,てじま
手嶋	てしま,てじま
手嶌	てしま,てじま
狩集	かりあつまり,かりあつめ
狩生	かりう,かりゅう
狩野	かの,かのう,かりの
珠玖	しく,しゅく
種谷	たねたに,たねや
種田	おいた,おいだ,たねだ
酒見	さかみ,さけみ
酒匂	さかわ,さこ,さこう
酒本	さかもと,さけもと
首藤	しゅとう,しゅどう,すとう,すどう
寿盛	すさもり,すもり
寿谷	すだに,すや
樹下	きのした,じゅげ
樹神	こたま,こだま
周佐	しゅうさ,すさ
周村	しゅうむら,すむら
周東	しゅうとう,すとう
周藤	しゅうとう,すとう,すどう
周防	すお,すおう,すほう
宗	そう,むね,むねたか
宗形	むなかた,むねかた
宗正	むねまさ,やひろ
宗川	そうかわ,むねかわ
宗像	むなかた,むねかた
宗村	そうむら,むねむら
宗田	そうた,そうだ,むねた,むねだ
宗片	むなかた,むねかた
宗方	むなかた,むねかた
宗友	むねとみ,むねとも
宗利	そうり,むねとし
宗澤	むねさわ,むねざわ
修行	しゅうぎょう,しゅぎょう
洲	しゅう,すが
洲鎌	すかま,すがま
洲崎	すさき,すざき,すのさき
秀島	ひでしま,ひでじま
秀野	しゅうの,ひでの
秋	あき,ちゅう
秋月	あきずき,あきづき
秋鹿	あいか,あきしか
秋川	あきかわ,あきがわ
秋草	あきくさ,あきぐさ
秋沢	あきさわ,あきざわ
秋谷	あきたに,あきや
秋庭	あきにわ,あきば
秋濃	あきの,あきのう
秋冨	あきとみ,あきどみ
秋保	あきう,あきほ
秋里	あきさと,あきざと
秋澤	あきさわ,あきざわ
習田	しゅうた,しゅうだ,しゅった
舟越	ふなこえ,ふなこし
舟橋	ふなはし,ふなばし
舟崎	ふなさき,ふなざき
舟生	ふなおい,ふにゅう
集貝	しゅうかい,ためがい
住江	すみえ,すみのえ
住松	じゅうまつ,すみまつ
住谷	すみたに,すみや
住田	すみた,すみだ
住澤	すみさわ,すみざわ
十一	じゅういち,じゆういち,といち,とかず
十河	じゅうかわ,そがわ,そごう,とがわ
十亀	そがめ,とがめ
十合	そごう,とうごう
十時	とき,ととき,とどき
十川	そがわ,そごう,とがわ
十二村	じゅうにむら,とにむら
十日市	とうかいち,とおかいち
従二	じゅうじ,じゅうに
戎谷	えびすたに,えびすだに,えびすや
渋江	しぶえ,ふじえ
渋谷	しぶたに,しぶや
重松	かさまつ,しげまつ
重城	じゅうじょう,じょうじょう
重川	おもかわ,しげかわ
重谷	おもたに,おもや,しげたに
重田	おもだ,しげた
重藤	しげとう,しげふじ
重里	しげさと,じゅうり
宿利	しゅくり,やどり
宿里	しゅくり,やどり
宿輪	しくわ,しゅくわ
宿澤	しゅくさわ,しゅくざわ
祝	いわい,はふり,ほうり
祝田	いわいた,いわいだ,ほうた
祝迫	いわいさこ,いわいざこ
出井	いずい,いでい,でい
出羽	いずは,いずわ,でわ
出浦	いでうら,でうら
出雲	いずも,いづも
出岡	いずおか,いづおか,いでおか,でおか
出下	いでした,でした
出海	いずみ,いづみ
出間	いずま,いずるま,いづま,でま
出丸	いでまる,でまる
出宮	いずみや,でみや
出原	いずはら,いづはら,いではら,ではら
出戸端	でとはし,でとばた
出口	いでぐち,でぐち
出江	いずえ,いづえ
出崎	でさき,でざき
出山	いでやま,でやま
出沼	いでぬま,でぬま
出上	いでうえ,いでがみ
出水	いずみ,いでみ,いでみず,でみず
出水田	いずみた,いずみだ
出石	いずいし,いずし,いでいし,でいし
出倉	でくら,でぐら
出谷	いずたに,でたに,でや
出塚	でずか,でづか
出田	いずた,いでた
出頭	しゅっとう,でがしら
出納	すいとう,すいどう
出馬	いずま,いづま
出淵	いづぶち,いでぶち,でぶち
出本	いでもと,でもと
出木谷	できがい,できや
出野	いでの,での
出来田	できた,できでん
出路	でじ,でみち
出渕	いずぶち,いでぶち
出澤	いでさわ,いでざわ,でさわ,でざわ
春見	かすみ,はるみ
春原	すのはら,はるはら
春藤	しゅんとう,しゅんどう
春日川	かすがかわ,かすががわ
春別府	はるびゅう,はるべっぷ
初鹿野	はじかの,はつかの
初谷	はつがい,はつたに,はつや
初田	はつた,はつだ
初澤	はつさわ,はつざわ
所司	しょし,しょじ
所沢	しょざわ,ところざわ
諸角	もろかど,もろずみ
諸熊	もろくま,もろぐま
諸見謝	しょみじゃ,もろみじゃ
諸田	もろた,もろだ
諸木	もろき,もろぎ
助川	すけかわ,すけがわ
助田	すけた,すけだ
女屋	おなや,めや
女鹿	めか,めが
女川	おながわ,おんながわ,めがわ
鋤崎	すきさき,すきざき
鋤柄	すきから,すきがら
勝	かち,かつ
勝屋	かつや,しょうや
勝谷	かつたに,かつや,しょうや
勝地	かっち,かつち
勝田	かつた,かつだ,しょうだ
勝呂	かつろ,すぐろ
升谷	ますたに,ますや
升方	ますかた,ますがた
小﨑	こさき,こざき
小井	いさらい,おい,こい
小井戸	こいと,こいど
小井川	おいかわ,こいがわ
小永	おなが,こなが
小越	おごし,こごえ,こごし
小園	おぞの,こその,こぞの
小薗	おその,こぞの
小薗井	おそのい,おぞのい
小塩	おしお,おじお,こしお
小河	おがわ,おごう,こがわ
小河原	おがはら,おがわら,こがはら,こがわら
小河内	おごうち,こがうち
小花	おばな,こはな
小賀	おが,こが
小海	こうみ,こかい,こがい
小貝	おがい,こがい
小垣	おがき,こがき
小笠原	おがさはら,おがさわら
小鴨	おがも,こかも,こがも
小粥	おがい,こがい,こがゆ
小苅米	こかりまい,こがりまい
小貫	おぬき,こぬき
小関	おぜき,こせき,こぜき
小岸	おぎし,こぎし
小亀	こかめ,こがめ
小橋	こはし,こばし
小郷	おごう,こごう
小玉	こたま,こだま
小金沢	こがねさわ,こがねざわ
小金澤	こがねさわ,こがねざわ
小駒	おごま,ここま,こごま
小串	おぐし,こぐし
小窪	おくぼ,こくぼ
小熊	おくま,おぐま,こぐま
小熊坂	こぐまさか,こぐまざか
小栗栖	おぐりす,おぐるす
小形	おがた,こがた
小穴	おあな,こあな
小見	おみ,こみ
小原	おはら,おばら,こはら,こばら,こばる
小原澤	おはらざわ,こはらざわ
小古呂	おごろ,こころ
小口	おぐち,こくち,こぐち
小江	おえ,おごう
小高	おだか,こたか,こだか
小合	おごう,こごう
小黒	おぐろ,こぐろ
小根山	おねやま,こねやま
小佐々	こささ,こざさ
小佐井	こさい,こざい
小佐野	おさの,こさの
小座間	おざま,こざま
小材	おざい,こざい
小坂	おさか,こさか,こざか
小坂井	こさかい,こざかい
小坂部	おさかべ,こさかべ
小阪	こさか,こざか
小崎	おざき,こさき,こざき
小作	おさく,おざく,こさく
小笹	おささ,おざさ,こささ,こざさ
小山	おやま,こやま
小山田	おやまだ,こやまだ
小司	こじ,しょうじ
小枝	こえだ,さえだ
小寺	こてら,こでら
小鹿	おじか,こしか,こじか
小篠	おざさ,こしの
小酒	こさか,こさけ
小酒井	こさかい,こざかい
小舟	こふね,こぶね
小住	おずみ,こずみ
小出水	こいずみ,こいでみず
小勝	こかつ,こがち
小松田	こまつた,こまつだ
小沼	おぬま,こぬま
小城	おぎ,こしろ,こじょう
小場	こば,しょうば
小新	こしん,こじん
小森田	こもりた,こもりだ
小深田	こふかた,こぶかた
小神	おがみ,おこう,こがみ
小神野	おかの,おがみの
小針	こはり,こばり
小数賀	おすが,こすが
小菅	こすが,こすげ
小瀬	おせ,おぜ,こせ
小瀬木	おせき,おぜき
小川	おがわ,こがわ
小川原	おがはら,おがわはら,おがわら
小泉	こいずみ,こいづみ
小船	こふね,こぶね
小銭	こせに,こぜに
小善	こぜん,しょうぜん
小曽戸	おそど,こそと
小曽根	おぞね,こそね
小倉	おぐら,こくら
小早川	こはやかわ,こばやかわ
小村	おむら,こむら
小代	おじろ,こしろ
小鷹	おだか,こたか,こだか
小滝	おたき,おだき,こたき,こだき
小瀧	おたき,おだき,こたき
小沢	おざわ,こざわ
小只	おただ,こただ
小棚木	おだなぎ,こたなぎ
小谷	おたに,おだに,こたに,こだに
小谷松	おやまつ,こやまつ
小谷内	こやうち,こやち
小端	おばた,こばた
小竹	おだけ,こたけ,こだけ,しの
小竹原	こたけはら,こだけはら
小中	おなか,こなか
小張	おばり,こばり
小町	おまち,こまち
小長谷	おばせ,こながや,こはせ
小鳥	おどり,ことり
小津	おつ,おづ
小津間	こずま,こづま
小塚	こずか,こつか,こづか
小槻	おおづく,こつき
小辻	こつじ,こづじ
小堤	おつづみ,おづつみ,こつつみ,こつづみ,こづつみ
小田	おだ,こだ,しょうだ
小田々	おただ,おだた
小田金	おだかね,おだがね
小田原	おだはら,おだわら
小田切	おたぎり,おだぎり,こたぎり
小田中	おだなか,こだなか
小田島	おだしま,おだじま,こだしま
小田嶋	おだしま,おだじま
小田部	おたべ,こたべ
小渡	おど,こわたり
小土	おど,こづち
小島	おじま,こしま,こじま
小嶋	おじま,こじま
小藤	ことう,こふじ
小藤田	ことうだ,こふじた
小豆	あずき,しょうず
小豆生田	おまみゅうだ,こまめうだ
小豆沢	あずきさわ,あずきざわ
小豆澤	あずきさわ,あずきざわ,あづきざわ
小那覇	おなは,こなわ
小縄	おなわ,こなわ
小南	こなみ,こなん,こみなみ
小楠	おぐす,こぐす
小日向	おびなた,こひなた,こびなた
小波	こなみ,さざなみ
小波本	こはもと,ひやね
小迫	こさく,こさこ
小畑	おばた,こはた,こばた,こばたけ
小畠	おばた,こばた,こばたけ
小畔	おぐる,こあぜ
小比賀	おいか,おびか,こひが
小尾	おび,こび
小尾口	こうぐち,こおぐち
小美野	おみの,こみの
小桧山	こひやま,こびやま
小浜	おはま,おばま,こはま
小布施	おぶせ,こぶせ
小副川	おそえがわ,おぞえかわ,おぞえがわ,こふくがわ
小淵	おぶち,こぶち
小鮒	こふな,こぶな
小平	おだいら,こだいら,こひら
小暮	こくれ,こぐれ
小峰	おみね,こみね
小方	おかた,おがた
小北	おきた,こきた,こぎた
小堀	こほり,こぼり
小俣	おまた,こまた
小又	おまた,こまた
小無田	おむた,こむた
小椋	おぐら,こむく,こもく
小茂鳥	こもとり,こもどり
小木	おぎ,こぎ
小木曽	おぎそ,こぎそ
小野塚	おのずか,おのづか
小野坂	おのさか,おのざか
小野塚	おのずか,おのづか
小野木	おのき,おのぎ
小野里	おのさと,おのざと
小野澤	おのさわ,おのざわ
小薬	おぐすり,こぐすり,こずい
小柳	おやなぎ,こやなぎ
小柳津	おやいず,おやいづ
小葉竹	おばたけ,こばたけ
小里	おざと,おり,こさと,こざと
小立	おだち,こだち
小林	おばやし,こばやし
小路	こうじ,こみち,しょうじ
小路口	こじぐち,しょうじぐち
小禄	おろく,ころく
小和田	おわだ,こわだ
小嵜	おざき,こさき,こざき
小檜山	こひやま,こびやま
小條	こえだ,こじょう
小椚	おくぬぎ,こくぬぎ
小櫃	おびつ,こひつ,こびつ
小渕	おぶち,こぶち
小澤	おざわ,こさわ,こざわ
小濱	おばま,こはま
尚	しょう,たかし
庄垣内	しょうがいと,しょうごうち
庄谷	しょうたに,しょうや
庄田	しょうた,しょうだ
昇	のぼり,のぼる
晶	あき,あきら
松栄	しょうえい,まつえ,まつばえ
松延	まつのぶ,まつのべ
松薗	まつその,まつぞの
松家	まついえ,まつか,まつや
松角	まつかど,まつずみ
松橋	まつはし,まつばし
松金	まつかね,まつがね
松隈	まつくま,まつぐま
松形	まつかた,まつがた
松月	しょうげつ,まつづき
松原	まつはら,まつばら
松口	まつくち,まつぐち
松坂	まつさか,まつざか
松阪	まつさか,まつざか
松崎	まつさき,まつざき
松枝	まつえ,まつえだ
松上	まつかみ,まつがみ
松城	まつき,まつしろ
松生	まつい,まついき,まついけ,まつお
松川	まつかわ,まつがわ
松代	まつしろ,まつよ
松沢	まつさわ,まつざわ
松谷	まつたに,まつや
松塚	まつつか,まつづか
松鶴	まつつる,まつづる
松田	まつた,まつだ
松嶋	まつしま,まつじま
松藤	まつとう,まつふじ
松冨	まつとみ,まつどみ
松風	しょうふう,まつかぜ
松平	まつだいら,まつひら
松木	まつき,まつぎ
松門	まつかど,まつじょう
松梨	まつなし,まつり
松里	まつさと,まつざと
松澤	まつさわ,まつざわ
沼﨑	ぬまさき,ぬまざき
沼元	ぬまもと,ぬもと
沼崎	ぬまさき,ぬまざき
沼上	ぬまかみ,ぬまがみ
沼尻	ぬましり,ぬまじり
沼沢	ぬまさわ,ぬまざわ
沼波	ぬなみ,ぬまなみ
沼本	ぬまもと,ぬもと
沼里	ぬまさと,ぬまり
沼澤	ぬまさわ,ぬまざわ
焼山	やきやま,やけやま
焼田	やきた,やけだ
照	てらし,てらす
菖蒲	あやめ,しょうぶ
菖蒲谷	しょうぶたに,しょうぶだに,しょうぶや
上	うえ,かみ
上﨑	じょうさき,じょうざき
上ノ山	うえのやま,かみのやま
上井	うえい,うわい,かみい
上羽	うえは,うえば,うわば,かみわ
上運天	うえうんてん,かみうんてん
上永	うえなが,かみなが
上園	うえその,うえぞの,うえまつ,かみぞの
上薗	うえぞの,かみぞの
上遠野	かとうの,かとおの,かどうの,かどおの,かどの,かみとうの
上横手	うわよこて,かみよこて
上岡	うえおか,かみおか
上下	うえした,かみした
上加世田	うえかせだ,かみかせだ
上家	かみいえ,じょうや
上河原	かみかわら,かみがはら
上垣	うえがき,かみがき
上垣内	うえがいと,うえがきうち,かみがいち,かみがいと,かみごうち
上釜	うえかま,うえがま,かみがま
上間	うえま,じょうま
上関	うわせき,かみせき,かみぜき
上丸	うえまる,かみまる,かんまる,じょうまる
上岩	うえいわ,かみいわ
上久保	うえくぼ,かみくぼ
上宮	うえみや,かみのみや,かみみや
上橋	うえはし,かみはし
上金	うえかね,かみがね
上栗	かみくり,かみぐり
上形	うえがた,かみがた
上月	こうずき,こうつき,こうづき,じょうげつ
上兼	うえかね,うえがね
上見	あげみ,うえみ,かみ,じょうけん
上元	うえもと,かみもと
上原	うえはら,かんばら
上戸	うえと,かみと
上口	うえぐち,かみくち,かみぐち,じょうぐち
上江	うわえ,かみえ
上江洲	うえす,うえず,かみえす
上高	うえたか,かみたか
上根	うえね,かみね
上佐	うえさ,うわさ
上妻	あがつま,あげつま,うえづま,かみずま,かみつま,かみづま,こうずま,こうづま
上坂	うえさか,かみさか,こうさか,こおさか
上阪	うえさか,かみさか,こうさか
上崎	うえさき,かみさき,かみざき
上笹	うえささ,かみささ
上山	うえやま,かみやま
上枝	うええだ,うえだ,かみえだ
上寺	うえてら,かみでら
上蔀	うわしとみ,わしとみ
上手	かみて,かみで
上拾石	うえじゅっこく,かみじゅっこく
上重	かみしげ,じょうじゅう
上出	うえで,かみで
上小路	うえこうじ,かみこうじ
上床	うえとこ,うわとこ
上松	あげまつ,うえまつ
上沼	うえぬま,うわぬま,かみぬま
上城	うえしろ,うえじょう,うえんじょう,かみしろ,かみじょう
上条	うえじょう,かみじょう
上新	うえしん,かみしん
上森	うえもり,うわもり
上仁	うえに,じょうにん
上水	あげみず,うえみず,うわみず,かみみず
上水流	かみずる,かみづる
上西	うえにし,かみにし,じょうにし
上石	あげいし,かみいし
上川	うえかわ,かみかわ,かみがわ,じょうがわ
上川内	かみかわち,かみこうち,かみごうち
上泉	うわいずみ,かみいずみ
上前	うえまえ,かみまえ
上倉	うえくら,かみくら
上村	うえむら,かみむら,かんむら
上代	かじろ,かみしろ,かみだい,じょうだい
上滝	うえたき,かみたき,かみだき,こうたき,じょうたき
上瀧	うえたき,かみたき,こうたき,じょうたき
上沢	あげさわ,うえさわ,うわさわ,かみさわ,かみざわ
上谷	うえたに,かみたに,かみや
上段	うえだん,うえんだん,じょうだん
上地	うえじ,うえち,うえぢ,うわじ,かみじ,かみち
上中	うえなか,うわなか,かみなか
上仲	うえなか,かみなか
上辻	うえつじ,かみつじ
上田	あげた,うえた,うえだ,かみだ,かんだ
上土井	うえどい,かみどい,じょうどい
上島	うえしま,うえじま,かみしま,かみじま,じょうしま
上嶋	うえしま,うえじま,かみしま,かみじま,じょうしま
上東	うえひがし,かみひがし,じょうとう
上藤	うえとう,うえふじ,うわふじ
上内	うえうち,かみうち
上鍋	うえなべ,うじべ
上南	うえなみ,うえみなみ,かみみなみ
上之園	あげのその,うえのその,かみのその
上之薗	うえのその,かみのその
上馬	うえうま,じょうば
上迫	うえさこ,かみさこ
上畑	うえはた,かみはた
上尾	あがりお,うえお,のぼりお
上武	うえたけ,かみたけ
上部	うわべ,かんべ
上平	うえだいら,うえひら,うわだいら,かみたい,かみたいら,かみだいら,かみひら
上別府	うえんびゅう,かみべっぷ,びふ
上保	うわぼ,じょうほ
上方	かみかた,かみがた
上坊	うえぼう,じょうぼう
上牧	うえまき,かんまき
上堀	うえほり,うえぼり,うわぼり,かみほり
上本	あげもと,うえもと,かみもと,じょうもと
上木	うえき,かみき,じょうき
上門	うえかど,うえじょう,かみかど
上野	あがの,うえの,うわの,かみの,こうづけ
上矢	うわや,かみや
上里	あがり,うえさと,うえざと,うわさと,かみさと,こうざと
上林	うえばやし,かみばやし,かんばやし
上林山	かみばやしやま,かんばやしやま
上路	あげじ,うえじ,じょうじ
上脇	うえわき,かみわき
上條	かみじょう,じょうじょう
上澤	うえさわ,うえざわ,かみさわ,かみざわ
上續	うえつぎ,うえつぐ
乗越	のりこし,のりごえ
城	きずき,しろ,じょう,たち
城井	きい,しろい
城越	きごし,しろこし
城下	しろした,じょうか,じょうした
城家	しろや,じょういえ
城間	しろま,じょうま
城戸	きど,きのと
城口	しろぐち,じょうぐち
城崎	しろさき,じょうざき
城山	きやま,しろやま,じょうやま
城市	しろいち,じょういち
城所	きどころ,じょうしょ
城上	しろかみ,しろがみ
城森	きもり,じょうもり
城生	じょうの,じょうのう
城川	きがわ,しろかわ
城前	しろまえ,じょうぜん,じょうまえ
城村	しろむら,じょうむら
城多	きた,きだ
城谷	しろたに,じょうや
城塚	しつろか,しろつか,じょうつか
城島	じょうしま,じょうじま
城内	きうち,しろうち,じょうない
城之内	しろのうち,じょうのうち
城尾	しろお,じょうお
城本	しろもと,じょうもと
城野	しろの,じょうの
城和	しろわ,じょうわ
場谷	ばたに,ばや
常井	つねい,とこい
常喜	じょうき,つねき
常光	じょうこう,つねみつ
常住	つねすみ,つねずみ
常深	つねぶか,つねみ,つみね
常田	つねた,つねだ,ときた,ときだ
常木	つねき,つねぎ
畳谷	たたみたに,たたみだに
埴原	はいばら,はにはら,はにわら
埴田	はにた,はにだ,はねだ
植地	うえじ,うえち
植田	うえた,うえだ
植島	うえしま,うえじま
植嶋	うえしま,うえじま
織金	おりかね,おりがね
織原	おばら,おりはら
織戸	おりと,おりど
織田	おだ,おりた
織田沢	おたざわ,おだざわ
尻無浜	しなしはま,しりなしはま
信	しん,のぶ
信貴	しぎ,しんき
信山	しんやま,のぶやま
信清	しんせい,のぶきよ
信太	しだ,しんた,のぶた
信田	した,しだ,しなだ,しのだ,のぶた
信藤	しんとう,しんどう,のぶとう
新	あたら,あたらし,あら,あらた,あらたし,しん,にい
新﨑	あらさき,しんざき
新タ	あらた,にった
新鞍	あらくら,にいくら
新井	あらい,にい
新井田	あらいだ,にいだ
新岡	あらおか,しんおか,にいおか
新屋	あたらしや,あらや,しんや,にいや
新屋敷	あらやしき,しんやしき
新家	あらいえ,あらや,しんか,しんけ,しんや,にいのみ,にいや
新家谷	しんけや,しんげや
新海	しんかい,しんがい,にいのみ
新開	しんかい,しんがい
新貝	しんかい,しんがい
新垣	あらかき,あらがき,しんがき,にいがき
新関	にいせき,にいぜき
新舘	しんたて,にいだて
新宮	あらみや,しんぐう,しんみや
新居	あらい,にい,にいい,におり
新見	あらみ,しんみ,にいみ
新元	あらもと,しんもと,にいもと
新原	しんはら,しんばら,にいはら,にいばる
新戸	しんと,しんど
新江	あらえ,しんえ
新行内	しんぎょううち,しんぎょうじ,しんぎょうち
新国	にいくに,にっくに
新座	しんざ,にいくら
新妻	あづま,にいつま,にいづま
新坂	しんさか,にいさか
新崎	あらさき,しんざき,にいざき
新山	あらやま,しんやま,にいやま
新治	あらはる,しんじ,にいはり
新実	にいのみ,にいみ
新出	しんで,にいで
新城	あらき,あらしろ,しんじょう
新森	しんもり,にいもり
新正	あらまさ,しんじょう
新生	しんじょう,にいぶ
新西	しんざい,しんにし
新川	あらかわ,しんかわ,にいかわ,にいがわ,にっかわ
新倉	あらくら,しんくら,にいくら
新村	しんむら,にいむら
新沢	あらさわ,しんざわ,にいざわ
新谷	あらたに,あらや,しんがい,しんたに,しんや,にいたに,にいや,にたに
新竹	あらたけ,しんたけ
新町	しんちょう,しんまち
新田	あらた,しんた,しんでん,にった
新田見	しんたみ,にたみ,にったみ
新藤	しんとう,しんどう
新道	しんどう,しんみち
新内	しんうち,にいない,にうち
新埜	あらの,しんの,にいの
新納	あらの,しんのう,にいの,にいのう,にいろ,にいろう
新畑	あらはた,しんばた
新美	しんみ,にいのみ,にいみ
新苗	しんなえ,にいなえ
新浜	しんはま,にいはま
新武	あらたけ,しんぶ,にいたけ
新福	しんふく,しんぷく
新平	しんひら,にいひら
新保	しんぼ,しんぼう,しんぽ,にいほ,にいぼ
新甫	しんぼ,しんぽ,にいぼ
新穂	にいほ,にいぼ
新堀	しんぼり,にいほり,にいぼり
新本	あらもと,しんもと,にいもと
新名	しんみょう,しんめい,にいな
新明	しんみょう,しんめい
新免	しんめい,しんめん
新木	あらき,しんき
新目	あらため,あらめ,しんめ
新門	あらかど,しんもん
新野	あらの,しんの,にいの
新夕	あらゆう,にった
新羅	あらい,にら
新里	しんさと,しんざと,にいさと,にいざと,にっさと
新立	しんたて,しんだて,にったち
新留	あらと,しんとめ,しんどめ,にいどめ
新良	あら,しんら,にいら,にら
新林	しんばやし,にいばやし
新實	にいのみ,にいみ
新澤	あらさわ,しんざわ,にいざわ
新濱	しんはま,にいはま
新藏	あらくら,しんくら,しんぞう
森塚	もりつか,もりづか
森園	もりその,もりぞの
森江	もりえ,もりや
森崎	もりさき,もりざき
森寺	もりてら,もりでら
森上	もりうえ,もりかみ,もりがみ,もりがみこ
森清	もりきよ,もりせ
森生	もりいけ,もりお
森滝	もりたき,もりたけ
森谷	もりたに,もりや
森塚	もりつか,もりづか
森藤	もりとう,もりふじ
森畠	もりはた,もりばた,もりばたけ
森平	もりだいら,もりひら
森澤	もりさわ,もりざわ
榛葉	しんは,しんば,はしば
深海	ふかうみ,ふかみ
深山	ふかやま,みやま
深城	ふかき,ふかしろ
深水	ふかみ,ふかみず,ふこうず
深代	ふかしろ,ふかよ
深沢	ふかさわ,ふかざわ
深谷	ふかがい,ふかたに,ふかや,みたに
深田	ふかた,ふかだ
深道	ふかどう,ふかみち
深堀	ふかほり,ふかぼり
深澤	ふかさわ,ふかざわ
真	さな,しん
真井	さない,まい,まない
真下	ました,ましも,まっか
真貝	しんかい,しんがい
真宮	しんぐう,まみや
真橋	まはし,まばし
真光	さねみつ,まみつ
真崎	まさき,まざき
真子	まこ,まご,まなこ,まなご
真城	しんじょう,まき
真川	さながわ,まがわ
真船	まふね,まぶね
真殿	まとの,まどの
真島	ましま,まじま
真嶋	ましま,まじま
真藤	しんとう,しんどう
真道	しんどう,まみち
真鍋	あみたに,まなべ
真能	まの,まのう
真尾	さなお,ましお
真部	まなべ,まべ
真柄	まから,まがら
真保	しんぼ,しんぽ
真方	まかた,まがた
真名子	なまご,まなこ,まなご
真木	さなぎ,まき
真里谷	まりたに,まりや
神	かみ,こう,じん
神園	かみその,かみぞの
神屋	かみや,こうや
神吉	かみよし,かんき
神宮	かみや,しんぐ,じんぐう
神宮司	じんぐうし,じんぐうじ
神橋	かみはし,かんばし
神郡	かみごおり,かんごおり
神原	かみはら,かんばら,こうはら,こうばら
神戸	かんこ,かんど,かんべ,こうべ,ごうど
神崎	かんざき,こうざき
神作	かみさく,かんさく,かんざく
神山	かみやま,こうやま
神社	かんじゃ,じんじゃ,じんや
神呪	かんの,かんのう
神出	かみで,じんで
神沼	かぬま,かみぬま
神場	かんば,じんば
神森	かみもり,かんもり
神瀬	かみせ,こうのせ
神西	かみにし,じんざい
神川	かみかわ,じんかわ
神前	かみさき,かみまえ,かんざき,こうさき,こうざき
神村	かみむら,こうむら
神代	かくみ,かじろ,かみしろ,くましろ,こうしろ,こうじろ,じんだい
神沢	かみざわ,かんざわ,こうざわ
神谷	かみたに,かみや,こうや,みたに
神長	かみなが,じんちょう
神鳥	かみとり,かんどり
神津	こうず,こうづ
神通	じんずう,じんつう,じんづう
神塚	かみつか,かみづか
神定	かみさだ,かんじょう
神庭	かんば,じんば
神殿	こうどの,こどの
神田	かんだ,こうだ,じんでん
神奴	かみやっこ,しんど
神島	かみしま,かみじま,こうしま
神嶋	かみしま,かみじま
神藤	かみふじ,かんどう,しんとう,しんどう,じんとう,じんどう
神頭	かんとう,こうず,しんどう
神道	しんどう,じんどう
神徳	こうとく,しんとく,じんとく
神内	かみうち,じんない
神南	かみなみ,かんなみ
神之田	かみのた,かみのだ
神納	かんのう,じんのう
神能	かんの,かんのう,じんのう
神農	かみのう,かんの,こうのう,しんのう,じんの
神馬	じんば,じんま
神尾	かみお,かんお,しんのお
神品	こうしな,こうじな
神部	かみべ,かんぶ,かんべ,じんぶ
神辺	かんなべ,かんべ,しんべ
神保	しんぼ,じんぼ,じんぼう,じんぽう
神木	かみき,かんき,しんのき
神門	かみかど,かんど,かんもん,ごうど,ごうどう,しんもん
神野	かみの,かんの,こうの,じんの
神野志	かみのし,こうのし
神余	かなまる,しんよ
神里	かみさと,かみざと,かんざと
神立	かみだて,かんだち,かんだつ,かんだて,じんたて
神嵜	かんざき,こおざき
神澤	かみさわ,かみざわ,かんざわ
秦	しん,はた,はだ
秦野	しんの,はたの,はだの
薪苗	まきない,まきなえ
親川	おやかわ,しんかわ
進	しん,すすむ
進士	しんし,しんじ
進藤	しんとう,しんどう
進来	すすき,すずき
針生	はりう,はりゅう
針替	はりかい,はりかえ
針谷	はりがい,はりがえ,はりがや,はりや
仁井田	にいた,にいだ
仁熊	にくま,にぐま
仁戸田	にえた,にえだ,にとだ
仁杉	にすぎ,ひとすぎ
仁村	にむら,ふたむら
仁張	にんばり,にんぼり
仁田	にた,にった
仁田原	にたはら,にたばる
仁瓶	にへい,にべ
仁部	にぶ,にべ
仁平	にだいら,にひら,にへい
仁木	にき,にっき
仁礼	にれ,にれい
仁禮	にれ,にれい
壬生	いくるみ,みぶ
甚田	じんた,じんだ
陣内	じんない,じんのうち
諏江	すい,すえ
諏訪内	すわない,つわうち
諏澤	すさわ,すざわ
須々木	すすき,すずき
須加	すか,すが
須賀	すか,すが
須賀原	すがはら,すがわら
須崎	すさき,すざき
須川	すかわ,すがわ
須谷	すがい,すたに,すだに,すや
須知	しうち,しゅうち,すち
須藤	すとう,すどう
須方	すかた,すがた
酢谷	すたに,すだに
図師	ずし,づし
吹越	ふきこし,ふっこし
吹上	ふきあげ,ふきがみ
吹田	すいた,ふきた,ふきだ
垂	たるみ,たれ
垂水	たるみ,たるみず
水柿	みずかき,みずがき
水原	すいばら,みずはら
水戸	すいど,みずと,みと
水戸川	みとかわ,みとがわ
水口	みずくち,みずぐち,みづぐち,みなくち,みなぐち
水江	みずえ,みずのえ
水主	すいしゅ,みずし
水上	みずかみ,みずがみ,みなかみ
水城	みずき,みずしろ
水谷	みずがい,みずたに,みずのや,みずや
水町	みずまち,みづまち
水津	すいず,すいつ,すいづ
水田	すいた,みずた,みづた
水渡	すいと,みと
水本	みずもと,みづもと
水門	すいもん,みずかど
水溜	みずたまり,みずため
嵩	かさみ,だけ
嵩原	たかはら,たけはら
数原	かずはら,すはら
数納	かずのう,すのう
杉﨑	すぎさき,すぎざき
杉園	すぎその,すぎぞの
杉崎	すぎさき,すぎざき
杉上	すぎうえ,すぎがみ
杉生	すぎう,すぎお,すぎせ,すぎよ
杉谷	すぎたに,すぎや
杉目	すぎのめ,すぎめ
杉立	すぎたつ,すぎたて
菅	かん,すが,すげ
菅家	かんけ,すがや
菅間	かんま,すがま
菅原	すがはら,すがわら
菅崎	かんざき,すがさき
菅生	すがお,すがせ,すごう,すごお
菅川	すがかわ,すげかわ
菅谷	すがたに,すがや,すげのや
菅田	かんだ,すがた,すげた
菅嶋	すがしま,すがじま
菅納	かんの,すがのう
菅波	かんなみ,すがなみ
菅付	すがつき,すがつけ
菅野	かんの,すがの,すげの
雀部	ささいべ,ささべ
澄田	すみた,すみだ
摺寺	すりじ,すりでら
世永	せなが,よなが
世取山	せとりやま,よとりやま
世田	せた,よだ
世登	せと,よと
世木	せき,せぎ
世木田	せきた,せきだ
世良田	せらた,せらだ
瀬	せ,やなせ
瀬ノ口	せのくち,せのぐち
瀬越	せこし,せごえ,せごし
瀬下	せした,せしも,せじも
瀬戸口	せとくち,せとぐち
瀬上	せがみ,せのうえ
瀬谷	せたに,せや
瀬津	せっつ,せつ
瀬島	せしま,せじま
瀬之口	せのくち,せのぐち
瀬畑	せはた,せばた
瀬尾	せお,せのお
瀬木	せき,せぎ
畝田	あぜた,うねた,うねだ
畝本	あぜもと,うねもと
是津	ぜっつ,ぜつ
成井	なりい,なるい
成岡	なりおか,なるおか
成吉	なりよし,なるよし
成宮	なりみや,なるみや
成戸	なりと,なると
成山	なりやま,なるやま
成住	なりずみ,なるずみ
成瀬	なりせ,なるせ
成清	なりきよ,なるきよ,なるせ
成川	なりかわ,なりがわ,なるかわ
成沢	なりさわ,なるさわ
成谷	なりたに,なるたに
成塚	なりつか,なりづか
成田	なりた,なるた
成島	なりしま,なるしま
成内	なりうち,なるうち
成迫	なりさこ,なるさこ
成尾	なりお,なるお
成富	なりとみ,なるとみ
成冨	なりとみ,なるとみ
成本	なりもと,なるもと
成毛	なるけ,なるげ,なるも
成木	なりき,なるき
成澤	なりさわ,なるさわ
星谷	ほしたに,ほしや
星島	ほししま,ほしじま
晴	はるまき,はれ,はれまき
晴山	はるやま,はれやま
晴披	はるまき,はれまき
栖原	しゅはら,すはら
正	しょう,まさ
正井	しょうい,まさい
正垣	しょうがき,まさがき
正山	しょうやま,まさやま
正信	しょうしん,まさのぶ
正村	しょうむら,まさむら
正田	しょうだ,まさだ
正藤	しょうとう,まさとう
正坊地	しょうぼうじ,しょうぼうち
正野	しょうの,まさの
正林	しょうばやし,まさばやし
正路	しょうじ,しょうろ
正脇	しょうわき,まさわき
清	きよ,きよし,せい
清遠	きよとう,きよとお
清家	きよか,きよや,せいけ
清間	きよま,せいま
清久	きよく,せいきゅう
清宮	きよみや,せいみや
清山	きよやま,せいやま
清住	きよすみ,きよずみ
清水	きよみず,しみず
清水上	しずがみ,しみずがみ
清川	きよかわ,せいがわ,せがわ
清沢	きよさわ,きよざわ
清谷	きよたに,せいや
清塚	きよつか,きよづか
清田	きよた,きよだ,せいた,せいだ
清島	きよしま,きよじま,せいしま
清藤	きよとう,きよふじ,せいとう,せいどう
清木場	きよきば,きよこば,せいこば
清野	きよの,せいの
清利	きよとし,せいり
清澤	きよさわ,せいざわ
牲川	せがわ,にえかわ,にえがわ
生井	いくい,なまい
生稲	いくいな,いくいね
生永	いきなが,いくなが
生越	いきこし,いきごし,おごし,おごせ
生塩	うしお,おしお
生貝	いきがい,いけがい
生亀	いき,いきがめ
生原	いきはら,いくはら,はいばら
生山	いきやま,いくやま,おいやま
生松	いけまつ,おいまつ
生水	いきみず,おみず,しょうず
生瀬	いくせ,おうらい,おおせ,なませ
生盛	いくもり,せいもり
生川	いくかわ,いくがわ,おいかわ,なるかわ
生沢	いくさわ,いくざわ,いけざわ
生谷	いきたに,いくたに
生地	いきち,いくじ,いくち,いくぢ,おいじ,おいぢ,おち,しょうじ,せいち
生津	いきつ,なまず,なまづ
生天目	なばため,なまため
生田	いきた,いくた,しょうだ
生田目	いくため,なばため,なまため
生島	いきしま,いくしま,おじま,しょうじま
生嶋	いきしま,いくしま
生藤	いくとう,いけふじ
生内	うぶない,しょうない,はえうち
生南	いくなみ,しょうなん
生馬	いくま,いこま
生尾	いくお,なまお
生部	いくべ,いけべ,しょうぶ
生木	いくき,せいき,なるき
生野	いくの,うぶの,しょうの
生頼	おうらい,おおらい
生澤	いくさわ,いくざわ,いけざわ,うぶさわ
盛永	もりえ,もりなが
盛山	せいやま,もりやま
盛実	もりさね,もりざね
盛谷	さかりたに,もりたに,もりや
盛野	しげの,もりの
西家	にしいえ,にしけ
西海	さいかい,にしうみ,にしかい,にしがい
西開地	にしかいち,にしがいち
西垣内	にしがいち,にしがいと,にしがきうち
西潟	にしかた,にしがた
西舘	にしたて,にしだて
西丸	さいまる,にしまる
西亀	にしがめ,にしき
西宮	にしのみや,にしみや
西橋	にしはし,にしばし
西郡	にしごうり,にしごおり
西形	にしかた,にしがた
西原	さいばら,にしはら,にしばら
西戸	にしと,にしど
西光	さいこう,にしみつ
西坂	にしさか,にしざか
西阪	にしさか,にしざか
西崎	にしさき,にしざき
西出	にしいで,にしで
西勝	さいかつ,さいしょう,にしかつ
西上	にしうえ,にしかみ,にしがみ
西上床	にしうえどこ,にしうわとこ
西神	にしかみ,にしがみ
西須	さいす,にしす
西川	さいかわ,にしかわ,にしがわ
西川原	にしかわはら,にしかわら,にしがわら
西前	さいぜん,にしまえ
西側	にしがわ,にしら
西谷	にしたに,にしや
西谷内	にしやうち,にしやち
西端	にしはた,にしばた,にしべり
西地	にしじ,にしち
西津	にしず,にしつ,にしづ
西塚	にしつか,にしづか
西堤	にしつつみ,にしづつみ
西田	さいた,にした,にしだ
西島	にししま,にしじま
西藤	さいとう,にしふじ
西頭	さいとう,にしとう
西堂	さいどう,にしどう
西道	さいどう,にしみち
西迫	にしさこ,にしざこ,にしはく
西畑	にしはた,にしばた
西部	にしぶ,にしべ
西分	にしぶん,にしわけ
西方	にしかた,にしがた
西堀	にしほり,にしぼり
西明	さいみょう,さいめい,にしあき,にしあけ,にしみょう
西面	さいめん,にしお
西里	にしさと,にしざと
西林	にしはやし,にしばやし
西應	にしお,にしおう
西條	さいじょう,にしじょう
請田	うけた,うけだ
青海	あおがい,あおみ,おうみ,おおみ,せいかい,せいがい
青儀	あおき,あおぎ
青崎	あおさき,あおざき
青笹	あおささ,あおざさ
青枝	あおえ,あおえだ,あおし
青鹿	あおか,あおしか
青谷	あおたに,あおや
青地	あおじ,あおち,あおぢ
青塚	あおつか,あおづか
青柳	あおやぎ,あおやなぎ
静谷	しずたに,しずや
斉数	さいす,さいすう
斉田	さいた,さいだ
斉木	さいき,さえき
昔農	せきの,せきのう
石	いし,せき
石﨑	いしさき,いしざき
石王丸	いしおうまる,いしおまる
石下	いしおろし,いしげ,いしした
石河	いしかわ,いしこ,いしこう
石角	いしかど,いしずみ
石掛	いしかけ,いしがけ
石亀	いしかめ,いしがめ
石金	いしかね,いしがね
石隈	いしくま,いしぐま
石栗	いしくり,いしぐり
石兼	いしかね,いしがね
石見	いしみ,いわみ
石原	いしはら,いしわら
石戸	いしと,いしど
石戸谷	いしとや,いしどや
石高	いしたか,いしだか
石黒	いしくろ,いしぐろ
石坂	いしさか,いしざか
石阪	いしさか,いしざか
石崎	いしさき,いしざき
石司	いしづか,せきじ
石手洗	いしたらい,いしてあらい
石床	いしとこ,いしどこ
石上	いしかみ,いしがみ,いわがみ
石神	いしかみ,いしがみ
石瀬	いしせ,いしぜ
石積	いしずみ,いしづみ
石前	いしまえ,こくまえ
石曽根	いしそね,いしぞね
石倉	いしくら,いわくら
石沢	いしざわ,こくざわ
石谷	いしがい,いしたに
石地	いしじ,いしち
石津	いしず,いしつ,いしづ
石塚	いしずか,いしつか,いしづか
石庭	いしにわ,いしば
石田	いした,いしだ
石渡	いしわた,いしわたり
石動	いしどう,いするぎ
石突	いしずき,いしづき
石之野	いしの,いしのの
石迫	いしざこ,いしせこ
石附	いしずき,いしづき
石立	いしたて,いしだて
石留	いしとめ,いしどめ
石榑	いしくれ,いしぐれ
石澤	いしざわ,こくざわ
積山	せきやま,つみやま
積木	つむき,つむぎ
赤﨑	あかさき,あかざき
赤羽	あかは,あかはね,あかば,あかばね
赤羽根	あかはね,あかばね
赤熊	あかくま,あかぐま
赤穴	あかあな,あかな
赤崎	あかさき,あかざき
赤碕	あかさき,あかざき
赤山	あかやま,せきやま
赤司	あかし,あかつか
赤城	あかぎ,あかしろ,せきじょう
赤星	あかほし,あかぼし
赤沢	あかさわ,あかざわ
赤谷	あかたに,あかや
赤地	あかじ,あかち
赤築	あかつき,しゃづき
赤塚	あかつか,あかづか,せきづか
赤田	あかた,あかだ
赤土	あかつち,あかど,しゃくど
赤畠	あかはた,あかばたけ
赤部	あかべ,せきべ
赤穂	あかほ,あこう
赤堀	あかほり,あかぼり
赤木	あかき,あかぎ
赤刎	あかはね,あかばね
赤澤	あかさわ,あかざわ
赤穗	あかほ,あこう
切通	きりとおし,きりどおし
切明	きりあき,きりあけ
折下	おりした,おりしも
折谷	おりたに,かげしま
折敷	おしき,おりしき
設楽	したら,しだら
設樂	したら,しだら
説田	せった,せつた,せつだ
雪	すすぎ,ゆき
仙黒	せんくろ,せんごく
仙頭	せんとう,せんどう
仙洞田	せんどうた,せんどうだ
仙北谷	せんぼくや,せんぽくや
先崎	せんざき,まっさき,まつさき,まづさき
先田	さきた,さきだ
先名	さきな,せんな
先立	せんだち,せんだつ
千々岩	ちじいわ,ちちいわ,ちぢいわ,ちぢわ
千々波	ちぢなみ,ちぢわ
千羽	せんば,ちば
千賀	せんが,ちが
千貫	せんがん,ちぬき
千間	せんま,ちま
千歳	せんざい,ちとせ
千阪	せんざか,ちさか
千種	ちくさ,ちぐさ
千秋	せんしゅう,ちあき
千住	せんじゅ,せんじゅう
千森	せんもり,ちもり
千先	せんさき,せんざき
千川	せんかわ,ちかわ
千草	ちくさ,ちぐさ
千足	ちあし,ちそく
千代	せんだい,ちしろ,ちよ
千代谷	ちよたに,ちよや
千谷	せんや,ちや
千地	ちじ,ちぢ
千田	せんた,せんだ,ちだ
千年原	せんねんばら,ちとせはら
千馬	せんば,ちば
千北	ちきた,ちぎた
千本	せんぼん,せんもと,ちもと
千明	ちあき,ちぎら
千木良	ちきら,ちぎら
千野	せんの,ちの
千葉東	ちばと,ちばとう
千澤	せんざわ,ちざわ
川	かわ,やながわ
川羽田	かわはた,かわばた
川越	かわごえ,かわごし
川縁	かわぶち,かわべり
川下	かわした,かわしも
川原	かわはら,かわら
川原崎	かわはらさき,かわはらざき,かわらさき,かわらざき
川原田	かわはらだ,かわらだ
川原林	かわはらばやし,かわらばやし
川古谷	かわこたに,かわこや
川戸	かわと,かわど
川向	かわむかい,かわむき,かわむこう
川合	かわあい,かわい
川妻	かわつま,かわづま
川治	かわじ,かわち
川住	かわすみ,かわずみ
川尻	かわしり,かわじり
川人	かわと,かわひと,かわんど
川染	かわそめ,かわぞめ
川代	かわしろ,かわだい
川端	かわはた,かわばた
川地	かわじ,かわち,かわぢ
川中子	かわなかご,かわなご
川津	かわつ,かわづ
川添	かわそえ,かわぞい,かわぞえ
川田	かわた,かわだ
川東	かわとう,かわひがし
川藤	かわとう,かわふじ
川那子	かわなこ,かわなご
川内	かわうち,かわち
川南	かわなみ,かわみなみ
川幡	かわはた,かわばた
川畑	かわはた,かわばた
川畠	かわはた,かわばた
川副	かわそえ,かわぞえ
川分	かわけ,かわわけ
川平	かびら,かわひら
川辺	かわなべ,かわべ
川面	からづら,かわつら,かわづら,かわも
川連	かわつれ,かわづれ
川渕	かわふち,かわぶち
川邊	かわなべ,かわべ
川邉	かわなべ,かわべ
戦	いくさ,せん
扇	おうぎ,おおぎ
扇原	おうぎはら,おおぎはら,おぎはら
扇子	おおぎ,せんす
扇谷	おうぎたに,おうぎや,おおぎたに,おおぎや
扇田	おうぎた,おおぎだ,せんだ
扇澤	おうぎさわ,おおぎさわ
撰	えらび,えらぶ
泉	いずみ,いづみ
泉井	いずい,わくい
泉浦	いずうら,いずみうら
泉岡	いずおか,いずみおか
泉元	いずみもと,いずもと
泉原	いずはら,いずみはら
泉崎	いずさき,いずみさき,いずみざき
泉山	いずみやま,いずやま,いづみやま
泉森	いずみもり,いずもり
泉水	いずみ,せんすい
泉川	いずかわ,いずみかわ,いづみかわ
泉村	いずみむら,いずむら
泉谷	いずたに,いずみたに,いずみや,いづみや
泉池	いずいけ,いずち
泉田	いずた,いずみた,いずみだ,いづみた,せんだ
泉本	いずみもと,いずもと
泉名	いずみな,せんみょう
泉野	いずの,いずみの
泉澤	いずみさわ,いずみざわ
浅越	あさこし,あさごえ,あさごし,あざごえ
浅黄	あさお,あさぎ
浅賀	あさか,あさが
浅海	あさうみ,あさかい,あさのみ,あさみ
浅貝	あさかい,あさがい
浅見	あさみ,あざみ
浅妻	あさずま,あさつま,あさづま
浅上	あさかみ,あさがみ
浅生	あさい,あさお,あそう
浅谷	あさたに,あさや
浅地	あさじ,あさぢ
浅津	あさつ,あさづ
浅島	あさしま,あさじま
浅木	あさき,あさぎ
浅葉	あさは,あさば
洗川	あらいかわ,あらかわ
染谷	そめたに,そめや
箭内	やない,やんない
舛谷	ますたに,ますや
舛田	ますた,ますだ
船曳	ふなひき,ふなびき
船橋	ふなはし,ふなばし
船原	ふなはら,ふなばら
船崎	ふなさき,ふなざき
船生	ふなお,ふにゅう
船造	ふなぞう,ふなづくり
船谷	ふなたに,ふなや
船迫	ふなさこ,ふなば
薦田	こもた,こもだ
銭場	せんば,ぜにば
銭谷	ぜにたに,ぜにや
銭田	ぜにた,ぜにだ,ぜんだ
前	すすめ,まえ
前﨑	まえさき,まえざき
前越	まえこし,まえごし
前園	まえその,まえぞの
前家	まえいえ,まえけ
前垣内	まえがいち,まえがいと
前角	まえかく,まえずみ
前橋	まえはし,まえばし
前原	まえはら,まえばら
前崎	まえさき,まえざき
前寺	ぜんでら,まえでら
前上	まえうえ,まえがみ
前場	ぜんば,まえば
前川	まえかわ,まえがわ
前多	まえた,まえだ
前沢	まえさわ,まえざわ
前田	まえた,まえだ
前田河	まえだがわ,まえだこ
前島	まえしま,まえじま
前嶋	まえしま,まえじま
前峠	まえだお,まえとうげ
前波	まえなみ,まえば
前馬	まえうま,まえば
前里	まえさと,まえざと
前佛	ぜんぶつ,まえぶつ
善住	ぜんじゅう,よしずみ
善積	よしずみ,よしづみ
善田	きだ,ぜんだ
善如寺	ぜんにょうじ,ぜんにょじ
全	ぜん,まったく
全田	ぜんだ,まった
膳亀	ぜんかめ,ぜんがめ
曾我部	そかべ,そがべ
曾田	あいた,あいだ,そだ
曽我部	そかべ,そがべ
曽小川	そおかわ,そおがわ
曽谷	そがや,そたに,そや
曽田	そた,そだ
曽布川	そふかわ,そぶかわ
曽良	かつら,そら
祖田	そた,そだ
祖父江	そふえ,そぶえ
祖母井	うばがい,そぼい
素川	すがわ,そがわ
倉益	くらます,くらみつ
倉家	くらいえ,くらけ
倉金	くらかね,くらがね
倉形	くらかた,くらがた
倉住	くらすみ,くらずみ
倉増	くらまし,くらます
倉谷	くらたに,くらや
倉爪	くらつめ,くらづめ
倉林	くらはやし,くらばやし
惣田	そうた,そうだ
早稲田	わさだ,わせだ
早乙女	さおとめ,そうとめ,そおとめ
早弓	はやみ,はやゆみ
早原	はやはら,はやばら
早崎	はやさき,はやざき
早水	はやみ,はやみず
早船	はやふね,はやぶね
早田	そうだ,はやた,はやだ,わさだ
早馬	そうま,はやうま,はやま
巣瀬	すせ,すのせ
相越	あいこし,あいごし
相賀	あいか,あいが,おうが,おおが,さが
相原	あいはら,あいばら
相口	あいぐち,おのぐち
相崎	あいざき,さがさき
相上	あいかみ,あいがみ
相神	あいかみ,あいがみ
相沢	あいさわ,あいざわ,そうざわ
相知	あいち,おうち,おおち
相津	あいづ,そうず
相田	あいた,あいだ,そうだ
相島	あいしま,あいじま
相内	あいうち,あいない
相馬	あいば,そうま
相澤	あいさわ,あいざわ
糟谷	かすたに,かすや
草桶	くさおか,くさおけ
草賀	くさか,くさが
草原	くさはら,そうばる
草川	くさかわ,くさがわ
草島	くさしま,くさじま
草別	くさわき,くさわけ
草木迫	くさきさこ,くさきざこ
荘加	しょうか,そうか
荘司	しょうじ,そうじ
荘村	しょうむら,そうむら
荘田	しょうだ,そうだ
走出	はしで,はしりで
鎗田	かまた,やりた
霜出	しもいで,しもで
霜田	しもた,しもだ
霜澤	しもさわ,しもざわ
増見	ましみ,ますみ
増古	ましこ,ますこ
増山	ましやま,ますやま
増子	ましこ,ますこ
増沢	ますさわ,ますざわ
増谷	ましたに,ますたに,ますや
増地	ますち,ますぢ
増田	ますた,ますだ
増嶋	ますしま,ますじま
増野	ましの,ますの
蔵増	くらまし,くらます
蔵島	くらしま,ぞうしま
蔵富	くらとみ,とみくら
造田	そうだ,ぞうた,ぞうだ
側島	そばしま,そばじま
則次	のりつぎ,のりつぐ
束田	つかた,つかだ
足羽	あしば,あしわ
足沢	あしざわ,たるさわ
足立	あたち,あだち
速水	はやみ,はやみず
属	さっか,さつか
続橋	つづきはし,つづきばし
孫田	そんた,まごた
村下	むらした,むらしも
村家	むらい,むらいえ
村角	むらかく,むらかど,むらずみ
村岸	むらきし,むらぎし
村主	すぐり,つくり,むらぬし
村上	むらかみ,むらがみ
村城	そんじょう,むらき
村端	むらはし,むらはた
村地	むらじ,むらち
村林	むらはやし,むらばやし
多々納	たたの,たたのう,ただの,ただのう
多々野	たたの,ただの
多賀谷	たがたに,たがや
多胡	たこ,たご
多谷	たたに,ただに,たや
多地	たじ,たち
多田	おおた,ただ
多田井	たたい,ただい
多田見	たたみ,ただみ
多比良	たいら,たひら
多和田	たわた,たわだ
太井	おおい,ふとい
太地	たいじ,たいち
太中	おおなか,たなか,ふとなか,ふとなが
太田原	おおたはら,おおたわら
太島	おおしま,たじま
太附	たつき,たづけ
太良	たいら,たら
太郎浦	たろううら,たろうら
打越	うちこし,うちごし
打出	うちいで,うちで
打田	うちた,うちだ,うつだ
打樋	うちひ,うてび
柁原	かじはら,かじわら
陀安	たやす,だやす
対比地	ついじ,ついひち
帯賀	おびか,おびが
帯谷	おびたに,おびや
帯刀	おびなた,たいとう,たてわき
待鳥	まちとり,まちどり
戴	いただき,たい
泰地	たいち,たいぢ
袋谷	ふくろたに,ふくろだに,ふくろや
鯛谷	たいたに,たいや
鯛島	たいしま,たいじま
代永	だいなが,よなが
代財	しろさい,しろざい
代市	しろいち,よいち
代田	しろた,だいた,だいだ,よだ
台	うてな,だい
台蔵	たいぞう,だいぞう
大安	たいあん,だいやす
大羽	おおはね,おおば
大越	おおこし,おおごえ,おおごし
大園	おおその,おおぞの
大堰	おおせぎ,おおぜき
大薗	おおその,おおぞの
大音	おおおと,おおと
大下	おおした,おおしも
大家	おおいえ,おおか,おおや,たいけ,だいけ
大河原	おおかわら,おおがわら
大賀	おおが,たいが
大海	おおうみ,おおがい,おおみ,だいかい
大海原	おおうなばら,わたのはら
大垣内	おおがいと,おおがきうち
大柿	おおかき,おおがき
大角	おおかど,おおがく,おおすみ,おかど
大楽	たいらく,だいらく
大釜	おおかま,おおがま
大萱	おおかや,おおがや,だいがや
大萱生	おおがゆ,おおがゆう
大関	おおせき,おおぜき,おぜき
大舘	おおざと,おおたち,おおだち,おおだて,おおや
大丸	おおまる,だいまる
大岸	おおきし,おおぎし
大喜	おおき,たいき,だいき
大喜多	おおきた,おおぎた
大亀	おおかめ,おおがめ,おおき
大久	おおく,おおひさ,だいひさ
大鋸	おおが,おおのこ
大峡	おおはざま,おおば
大郷	おおごう,おおさと,だいごう
大饗	おおあえ,おおわい
大金	おおかね,おおがね
大空	おおそら,おおぞら
大串	おおくし,おおぐし
大櫛	おおくし,おおぐし
大隈	おおくま,おおすみ
大栗	おおくり,おおぐり
大形	おおかた,おおがた,おかた
大兼	おおかね,おおがね
大見謝	おおみしゃ,おおみじゃ
大古	おおこ,おおふる
大庫	おおくら,おおこ,おおご,おくら
大戸	おおと,おおど,ねぎ
大胡	おおご,だいご
大胡田	おおこだ,おおごだ,おごた
大後	おおご,だいご
大口	おおくち,おおぐち
大工	おおく,おおぐ,だいく
大工原	だいくはら,だいくばら
大荒田	おおあらた,おおあらだ
大黒	おおくろ,おおぐろ,だいこく
大根田	おおねた,おおねだ
大堺	おおさかい,おおざかい
大作	おおさく,だいさく
大笹	おおささ,おおざさ
大司	おおじ,おおつかさ,たいし
大寺	おおてら,おおでら
大治	おおじ,おおはる
大住	おおすみ,おおすも
大出	おおいで,おおで
大床	おおとこ,おおどこ
大松	おおまつ,だいまつ
大鐘	おおかね,おおがね
大上	おおうえ,おおかみ,おおがみ,だいじょう
大上戸	おおかみど,だいじょうご
大城	おおき,おおぎ,おおしろ
大場	おおば,おば
大神	おおが,おおがみ
大仁	おおに,だいに,だいにん
大須賀	おおすか,おおすが
大菅	おおすが,おおすげ
大瀬戸	おおせと,おおせど
大成	おおなり,おおなる,だいなり
大星	おおほし,おおぼし
大西	おおにし,だいせい
大川原	おおかわら,おおがわら
大川内	おおかわうち,おおかわち,おおこうち
大前	おおさき,おおまえ
大束	おおたば,おおつか
大代	おおしろ,だいだい
大宅	おおたく,おおや
大沢	おおさわ,おおざわ
大達	おおだち,おおだて
大谷	おおがい,おおたに,おおや,だいたに
大谷内	おおやうち,おおやち
大地	おおじ,おおち
大智	おおち,おおとも
大長	おおちょう,おおなが,だいちょう
大津賀	おおつか,おおつが
大津谷	おおつたに,おおつや
大庭	おおにわ,おおば
大田	おおた,だいだ
大田原	おおたはら,おおたわら
大渡	おおと,おおわたり
大塔	おおとう,だいとう
大東	おおひがし,だいとう
大当	おおあたり,おおとう
大藤	おおとう,おおふじ,だいとう
大豆生田	おおまみうだ,おおまみゅうだ,おおまめうだ,おおまめせいた
大頭	おおがしら,だいとう
大堂	おおどう,だいどう
大洞	おおほら,おおぼら,だいどう
大道	おおみち,だいどう
大徳	おおとく,だいとく
大南	おおなみ,おおみなみ
大楠	おおくす,おおぐす
大日	おおくさ,だいにち
大日向	おおひなた,おおひゅうが
大日方	おおひなた,おおびなた,おびなた
大能	おおの,おおのう
大柏	おおかしわ,おおがし
大迫	おおさこ,おおせこ
大硲	おおさこ,おおば
大幡	おおはた,おおばた,おおばん
大畠	おおはた,おおばたけ
大美賀	おおみか,おおみが
大武	おおたけ,おおぶ
大部	おおぶ,おおべ,だいぶ
大伏	おおふし,おおぶし
大福	おおふく,だいふく
大淵	おおふち,おおぶち
大平	おおたいら,おおだい,おおだいら,おおひら
大保	おおぼ,おおやす,だいほ,だいぼ
大方	おおかた,おおがた
大坊	おおぼう,だいぼう
大本	おおもと,だいもと
大明	おおあき,だいみょう
大毛	おおけ,おおげ
大木	おおき,おおぎ,たいき
大木島	おおきしま,おおきじま
大目	おおめ,だいめ
大門	おおかど,だいもん
大野田	おおのた,おおのだ
大野木	おおのき,おおのぎ
大柳	おおやぎ,おおやなぎ,おやなぎ
大用	おおよう,だいよう
大利	おおとし,おおり,だいり
大良	おおら,だいら
大隣	おおとなり,おおどなり
大和	おおわ,おわ,やまと
大和久	おおわく,おわく
大和谷	おわたに,やまとだに,やまとや
大和田野	おおわだの,おわだの
大佛	おおふつ,おさらぎ
大國	おおくに,おおぐに
大寶	おおたから,おおだから
大峽	おおば,おおばさま
大嶽	おおたけ,おおだけ
大幢	おおど,おおどう
大條	おおえだ,だいじょう
大渕	おおふち,おおぶち
大澤	おおさわ,おおざわ
大籠	おおこもり,おおごもり
鷹羽	たかのは,たかは,たかば
鷹合	たかあい,たかごう
鷹松	たかしょう,たかまつ
鷹栖	たかす,たかのす
鷹田	たかた,たかだ
鷹箸	たかのはし,たかはし
鷹木	たかき,たかぎ
鷹澤	たかさわ,たかざわ
鷹觜	たかのはし,たかはし
滝戸	たきと,たきど
滝川	たきかわ,たきがわ
滝谷	たきたに,たきや
滝平	たきだいら,たきひら
滝澤	たきさわ,たきざわ
瀧上	たきうえ,たきがみ
瀧川	たきかわ,たきがわ
瀧谷	たきたに,たきや
瀧島	たきしま,たきじま
瀧藤	たきとう,たきふじ
瀧波	たきなみ,たつなみ
沢崎	さわさき,さわざき
沢谷	さわたに,さわや
沢渡	さわたり,さわど
沢登	さわと,さわのぼり
沢辺	さわなべ,さわべ
沢里	さわさと,さわざと
蛸島	たこしま,たこじま
但田	たじた,ただ
但木	たたき,ただき
達	たち,たつ,だて
達下	たつした,たてした
達家	たつか,たつや
達川	たちかわ,たつかわ
辰口	たつくち,たつぐち
辰馬	たつうま,たつま
棚橋	たなはし,たなばし
棚沢	たなさわ,たなざわ
棚澤	たなさわ,たなざわ
谷﨑	たにさき,たにざき
谷井	たにい,やつい
谷河	たにかわ,たにがわ,やがわ
谷貝	たにがい,やがい
谷垣内	たにがいち,たにがいと
谷亀	たにかめ,やがめ
谷戸	たにと,やと
谷口	たにぐち,やぐち
谷高	やたか,やだか
谷治	たにじ,やじ
谷所	たにしょ,たにじょ,たにどころ,やどころ
谷上	たにうえ,たにがみ
谷生	たにう,たにしょう
谷川	たにかわ,たにがわ
谷川原	たにがわら,やがはら
谷村	たにむら,やむら
谷沢	たにざわ,やざわ
谷谷	たにや,やや
谷端	たにはし,たにはた,たにばた
谷地	たにち,やち
谷地田	たにちだ,やちた,やちだ
谷中	たになか,やなか
谷津	たにつ,たにづ,やず,やつ,やづ
谷塚	たにづか,やつか
谷田	たにた,たにだ,やた,やつだ
谷田貝	たやがい,やたがい
谷島	たにしま,やじま
谷嶋	たにしま,たにじま,やしま,やじま
谷藤	たにふじ,やとう
谷内	たにうち,たにない,やち,やない
谷内田	やうちだ,やちた,やちだ
谷木	たにき,やぎ
谷野	たにの,やの
谷利	たにかが,たにり
谷澤	たにさわ,たにざわ,やざわ
樽井	たる,たるい
樽家	たるい,たるや
樽谷	たるたに,たるや
丹羽	たんば,には,にわ
丹家	たんけ,たんげ
丹菊	たんきく,たんぎく
丹山	たんやま,にやま
丹治	たじみ,たんじ
丹生	たんしょう,たんじょう,たんせい,にう,にお,にぶ,にゅう,ぶにう
丹生谷	にうのや,にうや,にぶや,にゅうのや
丹保	たんぼ,たんぽ
淡	あわ,だん
淡河	おうご,おごう,たんかわ
淡川	あいかわ,あわかわ
淡谷	あわたに,あわや
淡地	あわじ,あわち
淡野	あわの,たんの
淡輪	たんなわ,たんのわ
炭竃	すみかま,すみがま
炭谷	すみたに,すみや
炭竈	すみかま,すみがま
端	はし,はた,はな
端崎	はしざき,はたさき
端山	はしやま,はやま
端谷	はしたに,はしや,はなや
端本	はしもと,はたもと
鍛	かじ,きたい
鍛原	かじはら,かじわら
鍛治谷	かじたに,かじや
段上	だんがみ,だんじょう
男澤	おざわ,おとこざわ
知久	ちきゅう,ちく
知見	ちけん,ちみ
地引	じびき,ぢびき
地曳	じびき,ぢびき
地崎	じさき,ちさき,ちざき,ぢさき
地紙	じかみ,じがみ
地主	じぬし,ちぬし,ぢぬし
地神	じがみ,ぢがみ
地蔵	じぞう,ぢぞう
地村	ちむら,ぢむら
地土井	じどい,ちどい
地頭薗	じとうその,じとうぞの
地福	じふく,ぢふく
地良田	じらた,ぢらた
池ヶ谷	いけがや,いけたに
池戸	いけと,いけど
池照	いけしょう,いけてる
池上	いけうえ,いけがみ,いけのうえ
池川	いけかわ,いけがわ
池袋	いけふくろ,いけぶくろ
池谷	いけがや,いけたに,いけのや,いけや
池端	いけはた,いけばた,いわはた
池津	いけつ,いけづ
池島	いけしま,いけじま
池嶋	いけしま,いけじま
池畑	いけはた,いけばた
池畠	いけはた,いけばた
池末	いけすえ,いけまつ
池渕	いけふち,いけぶち
池澤	いけさわ,いけざわ
池邊	いけのべ,いけべ
置鮎	おきあい,おきあゆ
置塩	おきしお,おしお
遅塚	おそづか,ちづか
築舘	ちくだて,つきだて
築城	ついき,つゆき
築谷	つきたに,つきや
築地	ついじ,ついぢ,つきじ,つきぢ
築野	ちくの,つくの,つの
竹﨑	たけさき,たけざき
竹越	たけこし,たけごし
竹園	たけその,たけぞの
竹延	たけのぶ,たけのべ
竹花	たけはな,たけばな
竹間	たけま,ちくま
竹岸	たけきし,たけぎし
竹腰	たけこし,たけごし
竹崎	たけさき,たけざき
竹上	たけうえ,たけがみ,たけのうえ
竹森	たけのもり,たけもり
竹生	たけお,たけおい,たけふ,ちくぶ
竹川	たけかわ,たけがわ
竹谷	たけたに,たけや
竹端	たけはた,たけはな,たけばた
竹田	たけた,たけだ,ちくだ
竹田津	たけたず,たけたつ,たけたづ
竹内	たけうち,たけのうち
竹馬	ちくば,ちくま
竹迫	たかば,たけさこ,たけざこ
竹本	たけもと,ちくもと
筑井	ちくい,つくい
筑間	ちくま,つくま
筑紫	ちくし,つくし
茶園	ちゃえん,ちゃぞの
茶山	さやま,ちゃやま
茶谷	ちゃたに,ちゃだに,ちゃや
茶畑	ちゃばた,ちゃばたけ
茶木	ちゃき,ちゃぎ
茶野	さの,ちゃの
茶圓	ちゃえん,ちやえん
中	あたり,なか,なかば
中﨑	なかさき,なかざき
中羽	なかは,なかば
中永	なかえ,なかなが
中越	なかこし,なかごえ,なかごし
中園	なかその,なかぞの
中家	なかいえ,なかや
中河	なかかわ,なかがわ
中垣内	なかがいち,なかがいと
中舘	なかだち,なかだて
中熊	なかくま,なかぐま
中郡	ちゅうぐん,なかごおり
中後	ちゅうご,なかご
中込	なかごみ,なかごめ
中座	ちゅうざ,なかざ
中才	なかさい,なかざい
中崎	なかさき,なかざき
中三川	なかみかわ,なかみがわ
中司	なかし,なかじ,なかつか,なかつかさ
中子	なかこ,なかご
中舎	なかしゃ,なかや
中住	なかすみ,なかずみ
中重	なかしげ,なかじゅう
中出	なかいで,なかで
中楯	なかたて,なかだて
中所	ちゅうしょ,なかしょ
中小路	なかこうじ,なかしょうじ
中庄谷	なかしょうたに,なかしょうや
中上	なかうえ,なかがみ
中城	ちゅうじょう,なかぎ,なかしろ,なかじょう
中場	ちゅうば,なかば
中条	ちゅうじょう,ちょうじょう,なかじょう
中新	なかしん,なかにい
中神	なかかみ,なかがみ
中臣	なかおみ,なかとみ
中須賀	なかすか,なかすが
中静	なかしず,なかしずか
中川原	なかかわはら,なかがはら,なかがわら
中倉	なかくら,なかぐら
中代	なかしろ,なかだい
中谷	なかたに,なかだに,なかや
中地	なかじ,なかち,なかぢ
中陳	なかじん,なかぜ
中田	ちゅうだ,なかた,なかだ
中島	なかしま,なかじま
中嶋	なかしま,なかじま
中東	なかとう,なかひがし
中藤	なかとう,なかふじ
中道	ちゅうどう,なかみち
中納	なかの,なかのう
中農	なかの,なかのう
中馬	ちゅうば,ちゅうま,ちゅうまん,なかうま
中迫	なかさこ,なかせこ
中畠	なかはた,なかばたけ
中鉢	ちゅうばち,なかはち,なかばち
中畔	なかあぜ,なかぐろ
中尾	なかお,なかを
中武	なかたけ,なかぶ
中平	なかたい,なかだいら,なかひら
中保	なかほ,なかやす
中堀	なかほり,なかぼり
中満	ちゅうまん,なかみつ
中務	なかつか,なかつかさ
中名生	なかなお,なかのみょう
中明	なかあき,なかめい
中木	なかき,なかぎ
中目	なかのめ,なかめ
中浴	なかさこ,なかたに
中里	なかさと,なかざと
中里見	なかさとみ,なかざとみ
中留	なかとめ,なかどめ
中力	ちゅうりき,なかりき
中林	なかはやし,なかばやし
中國	なかくに,なかぐに
中嶌	なかしま,なかじま
中條	ちゅうじょう,なかじょう
中澤	なかさわ,なかざわ
中禮	ちゅうれい,なかれい
仲子	なかこ,なかご
仲村渠	なかんだかり,なかんだり
仲谷	なかたに,なかや
仲長	なかちょう,なかなが
仲田	なかた,なかだ
仲鉢	ちゅうばち,なかばち
忠田	ちゅうた,ちゅうだ
虫明	むしあき,むしあけ
樗沢	ぶなさわ,ぶなざわ
樗木	おうてき,おおてき,おてき,ちさき,ちしゃき
樗澤	ぶなさわ,ぶなざわ
猪ノ口	いのくち,いのぐち
猪井	いい,いのい
猪越	いこし,いごし,いのこし
猪岡	いおか,いのおか
猪久保	いくぼ,いのくぼ
猪熊	いぐま,いのくま
猪原	いのはら,いはら,いばら
猪口	いぐち,いのくち,いのぐち
猪坂	いさか,いのさか
猪阪	いさか,いのさか
猪崎	いさき,いざき
猪山	いのやま,いやま
猪鹿倉	いかくら,いがくら
猪狩	いかり,いがり
猪上	いがみ,いのうえ
猪川	いかわ,いのかわ
猪谷	いがや,いたに,いのたに
猪塚	いつか,いづか,いのつか
猪田	いだ,いのだ
猪内	いのうち,ししうち
猪八重	いのはえ,いのやえ,いやえ
猪尾	いお,いのお
猪部	いのべ,ししべ
猪木	いぎ,いのき
丁田	ちょうだ,まちだ
張	ちょう,はり
張替	はりかい,はりかえ,はりがい,はりがえ
朝賀	あさか,あさが
朝海	あさかい,あさみ
朝貝	あさかい,あさがい
朝戸	あさと,あさど
朝妻	あさずま,あさつま,あさづま
朝生	あさお,あさぶ,あそう
朝倉	あさくら,あさくろ
潮田	うしおだ,しおた
町谷	まちたに,まちや
町田	まちた,まちだ
調所	ずしょ,ちょうしょ
長	おさ,ちょう,はじめ
長栄	ちょうえい,ながえ
長家	ながい,ながいえ,ながや
長久	ちょうきゅう,ながひさ
長郷	ちょうごう,ながさと,なごう
長見	おさみ,ながみ
長原	おさはら,ながはら
長治	ちょうじ,ながじ
長宗	ながみね,ながむね
長神	ちょうじん,ながみ
長川	おさがわ,ながかわ
長束	ながつか,なつか
長村	おさむら,ながむら
長谷	ながたに,ながや,はせ
長谷地	ながやち,はせち
長田	おさだ,ちょうだ,ながた
長登	ながと,ながのぼり
長藤	ながと,ながとう,ながふじ
長内	おさない,ながうち
長南	おさなみ,ちょうなん,ながなみ
長能	ながの,ながのう
長富	おさとみ,ながとみ
長冨	ながとみ,ながどみ
長柄	ながえ,ながら
長名	おさな,ちょうな
長木	ちょうき,ながき
長野	ちょうの,ながの
長利	おさり,ながとし
長渕	ながふち,ながぶち
長澤	なかざわ,ながさわ,ながざわ
頂	いただき,ちょう
鳥羽	とば,とりば
鳥越	とりこえ,とりこし,とりごえ
鳥海	ちょうかい,とりうみ,とりかい,とりのうみ,とりみ
鳥潟	とりかた,とりがた
鳥飼	とりかい,とりがい
鳥生	とりう,とりゅう
鳥巣	とす,とりす
鳥沢	とりさわ,とりざわ
鳥谷	からすだに,とや,とりたに,とりや
鳥谷尾	とやお,とりやお
鳥谷部	とやべ,とりやべ
鳥塚	とりずか,とりつか,とりづか
鳥田	とりた,とりだ
鳥畑	とりはた,とりばたけ
鳥養	とりかい,とりがい
勅使河原	てしがはら,てしがわら
勅使瓦	ちょくしがわら,てしがわら
直川	なおかわ,のうがわ
珍部	ちんべ,よしべ
陳内	じんない,ぢんない
津	つ,つざき
津々木	つつき,つづき
津越	つごえ,つごし
津隈	つくま,つぐま,つのくま
津戸	つと,つど
津国	つくに,つのくに
津坂	つさか,つざか
津吹	つぶき,つぶく
津谷	つたに,つや
津藤	つとう,つどう
津之地	つのち,つのぢ
津波	つなみ,つは
津波古	つはこ,つばこ
津門	つかど,つと
津里	つさと,つり
津留	つとめ,つどめ,つる
津國	つくに,つのくに
椎橋	しいはし,しいばし
椎原	しいはら,しいばら
椎津	しいつ,しいづ
椎木	しいき,しいぎ,しいのき
槌谷	つちたに,つちや
追田	おいた,おいだ
追立	おいたち,おいたて
通	とおり,とおる
通崎	つうざき,みちざき
通山	つうやま,とおやま,とおりやま
塚越	つかこし,つかごし
塚原	つかはら,つかばら
塚崎	つかさき,つかざき
塚谷	つかたに,つかや
塚田	つかた,つかだ
塚島	つかしま,つかじま
栂村	つがむら,とがむら
槻	けやき,つき
槻木	つきのき,つぎき,つげき
辻永	つじえ,つじなが
辻上	つじかみ,つじがみ
辻谷	つじたに,つじや
蔦川	つたかわ,つたがわ
蔦谷	つたたに,つたや
椿井	つばい,つばきい
椿原	ちんばら,つばきはら,つばはら
椿谷	つばきだに,つばきや
坪谷	つぼたに,つぼや
釣井	つりい,つるい
釣谷	つりたに,つりや,つるや
釣部	つりべ,つるべ
鶴飼	つるかい,つるがい
鶴谷	つるがい,つるがや,つるたに,つるや
鶴田	つるた,つるだ
鶴房	つるふさ,つるぼう
鶴来	つるき,つるぎ
鶴留	つるとめ,つるどめ
堤	さげ,つずみ,つつみ
堤谷	つつみたに,つつみだに
堤中	だいなか,つつみなか
定田	さだた,じょうでん
定木	さだき,じょうぎ
提中	たいなか,だいなか
程塚	ほどつか,ほどづか
程田	ほとだ,ほどた,ほどだ
釘崎	くぎさき,くぎざき
泥谷	ひじや,ひぢや
笛田	ふえた,ふえだ
鏑木	かぶらき,かぶらぎ
鉄地河原	てちがわら,てっちかわはら
天井	あまい,てんじょう
天羽	あまう,あまは,あもう,てんば
天下井	あまがい,てんかい
天花寺	てんげいじ,てんげじ
天海	あまがい,てんかい
天坂	あまさか,てんさか
天崎	あまさき,あまざき
天春	あまかす,あまがす
天城	あまき,あまぎ
天生目	あまのめ,なばため
天川	あまかわ,あまがわ,てかわ
天村	あまむら,てんむら
天宅	あまのや,あまや,てんたく
天達	あまたつ,あまだつ
天谷	あまがい,あまたに,あまや,てんや
天田	あまた,あまだ,てんだ
天都	あまつ,あまみや
天粕	あまかす,あまがす
天畠	あまはた,てんばた
天保	あまやす,てんぽ
天方	あまかた,あまがた
天本	あまもと,てんもと
天毎木	あまき,あまぎ
天満	あまみつ,てんま
天明	てんみょう,てんめい
天木	あまき,あまぎ
添田	そえた,そえだ
殿垣内	とのがいち,とのがいと,とのがうち,とのがきうち,とのごうち
殿山	とのやま,どのやま
殿川	とのかわ,とのがわ
殿谷	とのがい,とのや
殿木	とのき,とのぎ
田	た,でん
田縁	たぶち,たべり
田下	たした,たしも,たのしも
田家	たいえ,たや
田角	たすみ,たつの
田近	たじか,たぢか
田隅	たすみ,たずみ
田熊	たくま,たぐま
田隈	たくま,たすみ
田原	たはら,たばら,たばる,たわら
田向	たむかい,たむき
田幸	たこう,たゆき
田高	たこう,たたか,ただか
田鎖	たくさり,たぐさり
田崎	たさき,たざき
田子	たこ,たご,たっこ
田所	たところ,たどころ
田上	たうえ,たがみ,たのうえ,たのかみ
田生	たしょう,たのう
田積	たつみ,たづみ
田草川	たくさかわ,たくさがわ,たぐさがわ
田地	たち,たぢ
田島	たしま,たじま
田嶋	たしま,たじま
田頭	たがしら,たどう,でんどう
田内	たうち,たない,たのうち
田畑	たはた,たばた
田付	たつき,たつけ
田附	たつき,たつけ,たづき,たづけ
田部	たなべ,たべ
田部井	たべい,ためがい
田伏	たふし,たふせ,たぶし,たぶせ
田平	たひら,たびら
田辺	たなべ,たべ
田保	たぼ,たやす
田甫	たほ,たぼ,たんぼ
田母神	たぼがみ,たもかみ,たもがみ
田房	たふさ,たぶさ
田名部	たなぶ,たなべ
田面	たづら,たなぼ
田面木	たもぎ,たものき
田野	たの,でんの
田里	たさと,たり
田立	たたち,ただち
田林	いこま,たばやし
田路	たじ,とうじ
田嶌	たしま,たじま
兎田	うだ,とだ
塗師	ぬし,ぬりし
渡	わたり,わたる
渡井	わたい,わたらい
渡海	とかい,わたるみ
渡貫	わたぬき,わたふき
渡久地	とくち,とぐち
渡慶次	とけし,とけじ
渡口	とぐち,わたりぐち
渡司	わたし,わたじ
渡瀬	わたせ,わたらせ
渡部	わたなべ,わたのべ,わたぶ,わたべ
渡木	とねぎ,わたき
渡會	とごう,わたらい
登	のぼり,のぼる
登玉	とだま,のぼりたま
登坂	とうさか,とさか,のぼりさか
登川	とがわ,のぼりかわ
登田	とだ,のぼりた
登島	としま,とじま
登藤	とうどう,とどう
登本	ともと,のぼりもと
都	と,みやこ
都橋	とはし,とばし
都甲	とこう,とごう
都志	つし,づし
都出	つで,といで,とで
都地	つじ,とじ
都築	つずき,つづき
都竹	つたけ,つづき,つづく
都田	とだ,みやこだ
都島	つしま,としま
都木	たかぎ,とき
都澤	とざわ,みやこざわ
土井	つちい,どい
土井川	どいかわ,どいがわ
土井田	といだ,どいだ
土屋	つちや,ひじや
土釜	つちがま,どがま
土館	つちだて,どだて
土舘	つちたて,つちだて
土岐	とき,とぎ,どき
土橋	つちはし,どばし
土金	つちかね,つちがね
土江	つちえ,どえ
土江田	とえだ,どえだ
土山	つちやま,どやま
土師	はし,はじ,はせ,はぜ
土志田	つちしだ,としだ,どしだ
土松	つちまつ,どまつ
土上	つちがみ,どのうえ
土信田	としだ,どしだ
土性	どしょう,どじょう
土生	とき,どしょう,はぶ
土倉	つちくら,とくら,はくら
土代	つちしろ,どしろ,どだい
土谷	つちたに,つちや,とだに,どや
土地	とち,どち
土池	つちいけ,どいけ
土田	つちだ,とだ
土堂	つちどう,どとう
土肥	とひ,どい,どひ
土肥原	どいはら,どひはら
土部	どぶ,どべ
土方	ひじかた,ひじかわ
土本	つちもと,どもと
土木	どぼく,どろのき
土野	つちの,ひじの
土渕	つちぶち,どろぶち
奴賀	ぬか,ぬが
奴久妻	ぬくづま,ぬぐつま
刀田	とうだ,とだ
唐笠	からかさ,とうがさ
唐牛	からうし,からうじ,かろうじ
唐渡	からと,からわたり,とわたり
唐木	からき,とうき
唐木沢	からきさわ,からきざわ
塔本	とうもと,とのもと
塘	つつみ,とも
島	しま,はいしま,はいじま
島原	しまはら,しまばら
島崎	しまさき,しまざき
島上	しまかみ,しまがみ
島袋	しまぶく,しまぶくろ
島谷	しまたに,しまや
島地	しまじ,しまち
島津	しまず,しまつ,しまづ
島田	しまた,しまだ
島内	しまうち,しまのうち
嶋原	しまはら,しまばら
嶋崎	しまさき,しまざき
嶋谷	しまたに,しまや
嶋津	しまず,しまづ
嶋田	しまた,しまだ,しもだ
嶋内	しまうち,しまのうち
東	あずま,あづま,とう,ひがし
東井	あずまい,とうい
東浦	とううら,とうら,ひがしうら
東園	ひがしその,ひがしぞの
東岡	とうおか,ひがしおか
東恩納	ひがおんな,ひがしおんな
東家	とうげ,とうや
東海	あずみ,とうかい
東海林	しょうじ,とうかいりん
東垣外	あずまがいと,とうがいと,とうがいとう,ひがしがいと
東垣内	とうがきうち,ひがしがいと,ひがしがいとう
東間	あずま,とうま,ひがしま
東丸	とうまる,ひがしまる
東久保	とうくぼ,ひがしくぼ
東宮	とうぐう,とうみや
東金城	あがりかなぐすく,ひがしきんじょう
東元	とうもと,ひがしもと
東原	うのはら,とうはら,ひがしはら,ひがしばら
東狐	とうこ,とっこ
東口	とぐち,ひがしぐち
東江	あがりえ,とうえ,ひがしえ
東根	あずまね,ひがしね
東妻	あずま,あづま
東坂	とうさか,ひがしさか
東山	とうやま,ひがしやま
東出	とうで,ひがしで
東松	とうまつ,とおまつ
東森	とうもり,ひがしもり
東瀬	あずせ,とうせ
東川	あずまかわ,とうかわ,とがわ,ひがしかわ,ひがしがわ
東泉	とうせん,ひがしいずみ
東村	とうむら,ひがしむら
東谷	あずまや,とうたに,とうや,ひがしたに,ひがしだに,ひがしや
東端	とうばた,ひがしばた
東辻	とうつじ,ひがしつじ
東田	あずまだ,とうだ,ひがした,ひがしだ
東島	とうじま,ひがししま,ひがしじま,ひがしま
東嶋	とうじま,ひがしじま
東内	あずまうち,とうない,ひがしうち
東梅	とうばい,ひがしうめ
東迫	ひがしさこ,ひがしざこ
東畑	とうはた,とうばた,ひがしはた,ひがしばた
東畠	ひがしはた,ひがしばた
東浜	ありはま,ひがしはま
東平	とうひら,とうへい,ひがしひら
東保	とうほ,とうぼ,ひがしほ
東峰	とうみね,ひがしみね
東方	とうほう,ひがしかた
東本	とうもと,ひがしもと
東明	しのあき,とうめい
東木	とうき,とうぼく
東野	あずまの,とうの,ひがしの
東矢	とうや,ひがしや
東良	とうら,ひがしら
東林	とうりん,ひがしばやし
東脇	とうわき,ひがしわき
東條	とうじょう,とおじょう
桃井	ももい,もものい
桃原	とうばる,ももはら
桃崎	ももさき,ももざき
桃枝	ももえ,ももえだ
桃谷	ももたに,ももだに,ももや
桃田	ももた,ももだ
桃木	ももき,もものき
棟居	むねい,むねすえ
棟田	むねた,むねだ
棟方	むなかた,むねかた
淘江	ゆりえ,ゆるえ
湯ノ口	ゆのくち,ゆのぐち
湯下	ゆした,ゆのした
湯原	ゆはら,ゆばら
湯舟	ゆふね,ゆぶね
湯上	ゆがみ,ゆのうえ,ゆのえ
湯瀬	ゆせ,ゆぜ
湯川	ゆかわ,ゆがわ
湯沢	ゆさわ,ゆざわ
湯谷	ゆたに,ゆだに
湯地	ゆじ,ゆち,ゆぢ
湯田	ゆた,ゆだ
湯田坂	ゆだかさ,ゆださか
湯之上	ゆのうえ,ゆのがみ
湯木	ゆき,ゆぎ
当銘	とうめ,とうめい
等々力	とどりき,とどろき
筒口	つつぐち,どうぐち,どぐち
藤	とう,ふじ
藤ノ木	ふじのき,ふぢのき
藤井	ふじい,ふぢい
藤栄	とうえい,ふじえ
藤園	ふじその,ふじぞの
藤下	ふじした,ふじもと
藤家	ふじいえ,ふじか
藤間	とうま,ふじま
藤極	ふじきわ,ふじぎわ
藤原	ふじはら,ふじわら
藤咲	ふじさき,ふじさく
藤山	とうやま,ふじやま
藤次	とうじ,ふじつぐ
藤松	とうまつ,ふじまつ
藤上	ふじうえ,ふじかみ,ぶじがみ
藤城	ふじき,ふじしろ
藤生	ふじう,ふじお,ふじゅう
藤川	ふじかわ,ふぢかわ
藤倉	とうくら,ふじくら
藤多	ふじた,ふじたに
藤谷	ふじたに,ふじや,ふぢや
藤塚	ふじつか,ふじづか
藤島	とうしま,ふじしま,ふぢしま
藤東	とうどう,ふじとう
藤堂	とうどう,ふじむろ
藤内	とうない,ふじうち
藤武	とうたけ,ふじたけ
藤平	とうへい,ふじひら
藤平蔵	とうへいぞう,とへぞ,とへぞう
藤門	ふじかど,ふじもん
豆生田	まみゅうだ,まめうだ
豆田	まめた,まめだ
陶山	すやま,とうやま
堂下	どうした,どうもと
堂垣内	どうがうち,どうがきない
堂坂	どうさか,どうざか
堂上	どううえ,どうえ,どうがみ,どうじょう,どのうえ
堂前	どうぜん,どうまえ
堂端	どうはた,どうはな
堂田	どうた,どうだ
堂迫	どうさこ,どうせこ
洞	ほこら,ほら
洞口	どうぐち,ほらぐち
洞筒	どうとう,どとう
洞内	ほらうち,ほらない
道井	どい,どうい,みちい
道越	みちこし,みちごえ
道園	どうぞの,みちぞの
道音	どうおん,みちおと
道垣内	どうがいち,どうがうち,どがいど
道関	どうせき,みちぜき
道久	どうきゅう,みちひさ
道見	どうみ,みちみ
道原	どうばら,みちはら
道口	どうぐち,みちぐち
道向	みちむかい,みちむこ
道坂	どうさか,みちさか
道宗	どうしゅう,みちむね
道上	どうじょう,みちうえ,みちかみ,みちがみ
道城	どうじょう,みちしろ
道場	どうじょう,どうば,みちば
道正	どうしょう,みちまさ
道前	どうぜん,みちまえ
道谷	みちたに,みちや
道端	みちはた,みちばた
道地	どうち,みちじ
道塚	みちつか,みちづか
道田	みちた,みちだ
道島	どうじま,みちしま
道本	どうもと,みちもと
道又	どうまた,みちまた
道明	どうみょう,みちあき
道面	どうめん,みちも
道木	どうき,どうぎ,みちき
道林	どうりん,みちばやし
道籏	みちはた,みちばた
銅城	どうき,どうじょう
銅直	どうちょく,どうなお,どうべた
峠	たお,とうげ
峠岡	たおおか,みねおか
得丸	えまる,とくまる
得平	えひら,とくひら
徳家	とくか,とくや
徳住	とくすみ,とくずみ
徳川	とくがは,とくがわ
徳倉	とくくら,とくら
徳谷	とくたに,とくや
徳富	とくとみ,とくどみ
徳満	とくまん,とくみつ
徳留	とくとめ,とくどめ
禿	かむろ,とく
篤	あつし,とく
栃谷	とちたに,とちや
栃木	とちき,とちぎ
敦澤	あつさわ,つるさわ
頓宮	とんぐう,はみや,はやみ
頓所	とんしょ,とんどころ
頓田	とみた,とんだ
呑田	のみた,のんだ
奈川	なかわ,ながわ
奈倉	なくら,なぐら
奈良崎	ならさき,ならざき
奈良谷	ならたに,ならや
奈良部	ならぶ,ならべ
那賀	なか,なが
那谷	なた,なたに,なや
那波	ななみ,なば,なわ
内海	うちうみ,うちのみ,うちみ,うつみ
内潟	うちかた,うちがた
内舘	うちたて,うちだて
内出	うちいで,うちで
内城	うちしろ,うちじょう,ないじょう
内生蔵	うちうぞ,うちうぞう,うちおくら,うちおぞう,うちゅうぞう
内川	うちかわ,うちがわ
内多	うちた,うちだ
内谷	うちたに,うちや
内堀	うちほり,うちぼり
内木	うちき,ないき
内木場	うちきば,うちこば
内澤	うちさわ,うちざわ
鍋谷	なべたに,なべや
鍋澤	なべさわ,なべざわ
楢崎	ならさき,ならざき
楢本	なおもと,ならもと
楢木野	ならきの,ならぎの
縄田	なわた,なわだ
南井	なおい,みない,みなみい
南園	みなみその,みなみぞの
南館	なんかん,みなみだて
南舘	なんかん,みなみたて,みなみだて
南丘	みなおか,みなみおか
南原	なんばら,みなみはら
南口	なんこう,みなぐち,みなみぐち
南崎	みなみさき,みなみざき
南山	なんざん,みなみやま
南川	みなかわ,みながわ,みなみかわ,みなみがわ
南村	なむら,みなみむら
南谷	なんや,みなみたに,みなみだに,みなみや
南端	みなみはた,みなみばた
南中道	なんちゅうどう,みなみ,みなみなかみち
南田	なんだ,みなみだ
南島	なじま,なんしま,みなみしま,みなみじま
南嶋	みなみしま,みなみじま
南藤	なんとう,なんどう
南迫	みなみさこ,みなみせこ
南畑	みなみはた,みなみばた
南風原	はえばら,はえばる
南淵	なぶち,みなみふち,みなみぶち
南保	なんぼ,なんぽ
南方	なんぽう,みなかた,みなみかた,みなみがた
南本	みなみもと,みなもと
南木	なんき,なんもく,みなき
南野	なんの,のおの,みなみの
南里	なんり,みなみさと,みなみざと
南渕	なぶち,みなみぶち
南澤	みなみさわ,みなみざわ
南齋	なんさい,なんざい
楠	くす,くすのき
楠亀	くすかめ,くすがめ
楠橋	くすはし,くすばし
楠原	くすはら,くすばる
楠城	くすき,なんじょう
楠神	くすかみ,くすがみ
楠瀬	くすせ,くすのせ
楠生	くすお,くすばえ
楠畑	くすはた,くすばた
楠部	くすべ,なんぶ
楠木	くすき,くすのき
楠目	くすめ,くずめ
難波	なにわ,なんば
難波江	なばえ,なんばえ
二井	にい,ふたい
二井内	にいうち,にいない
二岡	におか,ふたおか
二関	にのせき,にのぜき
二宮	にのみや,ふたみや
二橋	にはし,ふたはし
二口	にぐち,ふたくち,ふたぐち
二上	にかみ,ふたかみ,ふたがみ
二神	ふたかみ,ふたがみ
二杉	にすぎ,ふたすぎ
二川	にかわ,ふたかわ,ふたがわ,ふたつかわ
二村	にむら,ふたむら
二谷	にたに,ふたたに,ふたつや
二塚	につか,ふたつか
二田	にた,にった,ふたた,ふただ
二渡	にわたり,ふたわたり
二島	にしま,ふたじま
二藤	にとう,にふじ
二藤部	にとうべ,にとべ
二俣	ふたつまた,ふたまた
二木	にき,ふたき,ふたぎ,ふたつき,ふたつぎ
尼崎	あまがさき,あまさき
尼谷	あまたに,あまや
尼田	あまた,あまだ
匂坂	さきさか,さぎさか
日髙	ひたか,ひだか
日永	ひえい,ひなが
日永田	ひえいだ,ひえだ
日下	くさか,ひした,ひしも,ひのした
日垣	ひかぎ,ひがき
日笠	ひかさ,ひがさ
日隅	ひぐま,ひずみ
日隈	ひぐま,ひのくま
日原	ひはら,ひばら
日戸	にっと,ひのと
日向	ひうが,ひなた,ひむかい,ひゅうが
日向野	ひがの,ひゅうがの
日高	ひたか,ひだか
日坂	にっさか,ひさか,ひざか
日沢	ひさわ,ひざわ
日置	ひおき,ひき,へき
日中	にっちゅう,ひなか
日渡	ひわたし,ひわたり
日納	ひの,ひのう
日馬	くさま,ひうま
日尾野	ひおの,ひびの
日暮	ひぐらし,ひぐれ
日本	にっぽん,ひのもと
日名子	ひなこ,ひなご
日野口	ひのくち,ひのぐち
日里	にっさと,ひざと
乳井	ちちい,にゅうい
乳原	うはら,うばら
入海	いりうみ,にゅうかい
入間田	いるまた,いるまだ
入戸野	いりとの,にっとの,につとの
入交	いりまじり,にゅうこう
入口	いりくち,いりぐち
入村	いりむら,にゅうむら
入沢	いりさわ,いりざわ
入谷	いりたに,いりや
入部	いりべ,いるべ,にゅうぶ
入澤	いりさわ,いりざわ
忍	おし,しのぶ
忍足	おしたり,おしだり
祢津	ねつ,ねづ
猫田	ねこた,ねこだ
熱海	あたみ,あつみ
濃野	こいの,のうの
納	おさむ,おさめ,なや
納所	のうしょ,のうそ
納庄	のうしょう,のうしよう
納村	なむら,のうむら
納富	のうとみ,のと
納冨	のうとみ,のうどみ
能見	のうみ,のみ
能口	のうぐち,のぐち
能崎	のうさき,のうざき,のざき
能城	のうじょう,のぎ,のしろ
能瀬	のうせ,のせ
能川	のうがわ,のがわ
能村	のうむら,のおむら,のむら
能沢	のうざわ,のざわ
能地	のうち,のうぢ
能津	のうづ,のづ
能田	のうた,のうだ
能島	のうじま,のしま,のじま
能木	あたぎ,のうぎ
播	はり,ばん
播谷	はりたに,はりや
播磨	はりま,ふくづみ
波間	なみま,はま
波形	なみかた,なみがた
波戸	なみと,はと
波佐間	はさま,はざま
波照間	なか,はてるま
波多	はた,はだ
波多腰	はたこし,はたごし
波多野	はたの,はだの
波津久	はずく,はづく
波田	なみた,はだ
馬越	うまこし,ばこし,まこし,まごし
馬屋原	うまやはら,まやはら
馬詰	うまづめ,ばづめ,まづめ
馬久地	まくち,めくち
馬橋	うまはし,まばし
馬原	うまはら,まはら,まばら
馬戸	うまと,ばと,まと
馬崎	うまざき,ばさき,まざき
馬飼野	まかいの,まがいの
馬上	ばじょう,まがみ,もうえ
馬場	ばば,ばんば
馬瀬	うませ,ませ,まぜ
馬川	うまかわ,ばがわ
馬替	まがい,まがえ
馬谷	うまたに,うまや
馬田	うまた,うまだ,まだ
馬渡	まわたり,もうたい
馬島	ましま,まじま
馬道	うまみち,ばどう
馬部	うまべ,ばべ
馬木	うまき,まき
配島	はいしま,はいじま
倍田	ましだ,ますだ
梅	うめ,めい
梅﨑	うめさき,うめざき
梅園	うめその,うめぞの
梅原	うめはら,うめばら
梅咲	うめさき,うめざき
梅崎	うめさき,うめざき
梅沢	うめさわ,うめざわ
梅谷	うめたに,うめや
梅地	うめじ,うめち
梅津	うめず,うめつ,うめづ
梅田	うめた,うめだ
梅内	うめうち,うめない
梅堀	うめほり,うめぼり
梅里	うめさと,うめざと
萩原	はぎはら,はぎわら
萩森	はぎのもり,はぎもり
萩生田	はぎうだ,はぎゅうだ
萩谷	はぎたに,はぎや
萩野谷	おぎのや,はぎのや
萩澤	はぎさわ,はぎざわ
伯耆田	ほうきた,ほうきだ
柏井	かしい,かしわい
柏原	かしはら,かしわばら,かしわばわ,かしわら
柏倉	かしくら,かしわくら,かしわぐら
柏村	かしむら,かしわむら
柏谷	かしたに,かしわだに,かしわや
柏俣	かしまた,かしわまた
柏木	かしわき,かしわぎ
柏野	かしの,かしわの
柏葉	かしば,かしわば
泊谷	とまりや,はくや
白圡	しらと,しらど
白井	しらい,しろい
白羽	しらは,しらば,しろは
白垣	しらがき,しろがき
白潟	しらかた,しろがた
白間	しらま,はくま
白岩	しらいわ,しろいわ
白金	しらかね,しろがね
白銀	しらかね,しろかね,しろがね
白熊	しらくま,しろくま
白戸	しらと,しろと,はくと
白砂	しらさご,しらすな,しらまさ
白坂	しらさか,しろさか
白崎	しらさき,しろさき
白山	しらやま,しろやま
白子	しらこ,しろこ,はくし
白松	しらまつ,しろまつ
白上	しらかみ,しらがみ,しろかみ
白神	しらかみ,しらが,しらがみ,しろかみ
白須賀	しらすか,しらすが
白水	しらうず,しらみず,しろうず,しろおず,しろず,しろみず,はくすい
白石	しらいし,しろいし,はくいし
白相	しらそう,しらと
白村	しらむら,しろむら
白谷	しらたに,しらや,はくや
白鳥	しらとり,しろとり
白津	しらつ,しらづ
白田	しらた,しろた,はくた
白土	しらつち,しらと,しらど
白藤	しらふじ,はくとう
白幡	しらはた,しろはた
白髪	しらか,しらが,しらがみ
白本	しらもと,しろもと
白木	しらき,しろき
白野	しらの,しろの,はくの
白柳	しらやなぎ,しろやなぎ
白嵜	しらさき,しろさき
白數	しらす,しろす
白澤	しらさわ,しろさわ
粕谷	かすたに,かすや
薄	うすき,すすき
薄衣	うすぎ,うすぎぬ
薄田	うすだ,すすきた,すすきだ
迫	さこ,せこ,はざま
迫田	さこた,さこだ,はくた
迫平	さこひら,せこひら
麦谷	ばくや,むぎたに,むぎや
箱田	はこた,はこだ
箱島	はこしま,はこじま
硲	さこ,はざま
櫨	はじ,はぜ
櫨本	はしもと,はぜもと
幡田	はただ,はりた
幡野	はたの,はんの
畑原	はたけはら,はたはら
畑崎	はたさき,はたざき
畑山	はたけやま,はたやま
畑上	はたうえ,はたがみ
畑沢	はたけざわ,はたざわ
畑谷	はたたに,はたや
畑地	はたじ,はたち
畑田	はたけだ,はただ
畑島	はたしま,はたじま
畑嶋	はたしま,はたじま
畠	はた,はたけ
畠山	はたけやま,はたやま
畠中	はたけなか,はたなか
畠田	はたけだ,はただ
畠澤	はたさわ,はたざわ
八髙	やこう,やたか
八ヶ代	やかしろ,やがしろ
八家	はっか,はつか,やか
八角	はっかく,やすみ
八橋	やつはし,やはし
八月一日	ほずみ,ほづみ
八月朔日	ほずみ,ほづみ
八戸	はちのえ,はちのへ,やえ,やべ
八子	やこ,やこう,やご
八若	はちわか,やわか
八十川	やそかわ,やそがわ
八十島	やそしま,やそじま
八十嶋	やそしま,やそじま
八重	やえ,やしげ
八重川	やえかわ,やえがわ
八重嶋	やえしま,やえじま
八重柏	やえかしわ,やえがしわ
八上	やかみ,やがみ
八神	やかみ,やがみ
八尋	やしろ,やひろ
八須	はちす,やす
八川	はちかわ,やかわ
八倉	やくら,やぐら
八束	やつか,やつづか
八村	はちむら,やむら
八代	やぎ,やしろ,やつしろ
八代田	やしろだ,やよた
八谷	はちや,はつたに,やたがい,やたに,やだがい,やつや
八町	はっちょう,やまち
八鳥	はちとり,はっとり,はつとり
八田	はちだ,はった,やつだ
八田羽	はったは,やたば
八島	やしま,やじま
八藤	はっとう,やつふじ
八馬	はちうま,はちま,やば
八幡	はちまん,やはた,やわた
八尾	やお,やつお
八文字	はちもんじ,やつもんじ
八木	やぎ,やつき
八木ヶ谷	やきがや,やぎがや
八木原	やきわら,やぎはら
八野田	はちのた,はちのだ
八柳	はちやなぎ,やつやなぎ
八浪	やつなみ,やなみ
八筬	やおさ,やさお
鉢木	はちき,はちのき
抜井	ぬきい,ぬくい
塙	はなわ,はね
伴戸	はんと,ばんど
伴野	ともの,はんの,ばんの
半杭	はんくい,はんぐい
半谷	はんがい,はんたに,はんば,はんや
反田	そった,そりた,たんだ
反怖	たんぷ,たんぼ,たんぽ
反保	たんぼ,たんぽ
反甫	たんぼ,たんぽ
帆苅	ほかり,ほがり
板羽	いたは,いたば
板橋	いたはし,いたばし
板坂	いたさか,いたざか
板崎	いたさき,いたざき
板川	いたかわ,いたがわ
板沢	いたさわ,いたざわ
板谷	いたたに,いただに,いたや,はんがい
板津	いたつ,いたづ
板東橋	ばんどうばし,ばんどばし
畔川	あぜかわ,くろかわ
畔田	あぜた,くろだ
畔柳	あぜやなぎ,くろやなぎ
繁田	しげた,はんだ
繁澤	しげさわ,しげざわ,はんざわ
飯	いい,めし
飯ヶ谷	いいがや,いがたに
飯井	いい,めしい
飯貝	いいかい,いいがい
飯干	いいほし,いいぼし
飯高	いいたか,いいだか
飯国	いいくに,いいぐに
飯坂	いいさか,いいざか
飯作	いいさく,はんさく
飯室	いいむろ,いむろ
飯星	いいほし,いいぼし
飯盛	いいもり,いさかり,いさがい
飯泉	いいいずみ,いいずみ
飯塚	いいずか,いいつか,いいづか,めしつか
飯田	いいた,いいだ,はんだ
飯藤	いいとう,はんどう
飯迫	いいさこ,いいざこ
飯冨	いいとみ,いいどみ,おぶ
飯國	いいくに,いいぐに
比屋根	ひやごん,ひやね
比田井	ひたい,ひだい
比島	ひしま,ひじま
緋田	あけた,あけだ
肥塚	こいづか,こえづか
肥沼	こいぬま,こえぬま,ひぬま
肥川	こいかわ,ひかわ
肥谷	ひだに,ひや
肥塚	こいづか,こえづか,ひつか,ひづか
肥田	こえだ,ひだ
肥土	あくと,ひど
飛岡	とびおか,ひおか
飛坂	とびさか,ひざか
飛山	とびやま,ひやま
飛弾	ひだ,ひだん
飛鳥間	あすかま,あすま
飛田	とびた,ひだ
飛渡	とびと,とびわたり,ひわたし,ひわたり
飛澤	とびさわ,とぶさわ
樋下	といした,ひのした
樋廻	ひばさみ,ひまわり
樋笠	ひかさ,ひがさ
樋高	てたか,ひだか
樋上	ひかみ,ひがの,ひがみ,ひのうえ
樋川	といかわ,ひかわ,ひがわ
樋泉	といずみ,ひいずみ
樋谷	ひたに,ひだに,ひや
樋爪	といづめ,ひずめ,ひづめ
樋田	といた,といだ,とよだ,ひだ
樋渡	ひわたし,ひわたり
樋之口	てのくち,ひのくち,ひのぐち
樋本	とよもと,ひのもと,ひもと
備瀬	びせ,びぜ
尾﨑	おさき,おざき
尾井	おい,おのい
尾家	おいえ,おや
尾原	おはら,おばら
尾高	おたか,おだか,すえたか
尾坂	おさか,おざか
尾崎	おさき,おざき
尾山	おのやま,おやま
尾子	おおじ,おこ
尾上	おうえ,おがみ,おのうえ,おのえ
尾城	おしろ,おじろ
尾前	おさき,おのまえ,おまえ
尾鷹	おたか,おだか
尾谷	おたに,おだに
尾田	おだ,びた
尾登	おと,おのぼり
尾嶋	おしま,おじま
尾藤	おとう,おふじ,びとう
尾道	おのみち,おみち
尾内	おうち,おない
尾白	おしろ,おはく
尾平	おひら,おびら
尾本	おのもと,おもと
尾野	おの,びの
尾立	おだち,おりゅう
尾路	おのみち,おろ
微笑	びしょう,ほほえみ
美斉津	みさいつ,みさいづ
美谷島	びやじま,みやじま
美津島	みずしま,みつしま
美藤	びとう,みとう
美濃	みの,みのう
美濃羽	みのは,みのわ
美濃田	みのた,みのだ
美尾谷	みおたに,みおのや
柊	ひいらぎ,ひらぎ
柊平	くいひら,くいびら
稗	はし,ひえ
稗貫	ひえぬき,ひぬき
稗田	ひえた,ひえだ
稗島	ひえしま,ひえじま
匹田	ひきた,ひきだ
疋田	あしだ,ひきた,ひきだ
菱谷	ひしたに,ひしのたに,ひしや
菱田	ひした,ひしだ
筆谷	ふでたに,ふでや
桧原	ひはら,ひばら
桧山	ひのやま,ひやま
桧谷	ひのきだに,ひのたに
姫田	ひめた,ひめだ
姫嶋	ひめしま,ひめじま
百々	とど,どうど,どうどう,どど,もも
百海	ひゃくかい,ももうみ,ももみ
百済	くだら,ひゃくさい,ももずみ
百崎	ももさき,ももざき
百瀬	ももせ,ももぜ
百石	ひゃくこく,ひゃっこく
百束	ひゃくそく,ももつか
百鳥	ももとり,ももどり
百塚	ひゃくづか,ももづか
百田	ひゃくた,ひゃくだ,ももた
百島	どうじま,ひゃくしま,ももしま
百嶋	ももしま,ももじま
百富	ひゃくとみ,ももとみ
百武	ひゃくたけ,ももたけ
百本	ひゃくもと,もももと
百名	ひゃくな,ももな
百目鬼	どうめき,どめき
百目木	どうめき,どめき
百野	ひゃくの,びゃくの
百澤	ももさわ,ももざわ
俵積田	たわらつみた,たわらつみだ
俵谷	たわらたに,たわらや,ひょうたに,ひょうだに
俵田	たわらだ,ひょうだ
俵木	たわらぎ,ひょうき
表田	おもだ,おもてだ,ひょうだ
表迫	おもてさこ,おもてざこ
表野	おもての,ひょうの
苗加	なえが,のうか
苗村	なえむら,なむら
苗代	ないしろ,なえしろ,なわしろ,のしろ
苗田	なえだ,のうだ,のだ
蛭子井	えびすい,ひるこい
蛭多	えびすた,えびすだ
浜家	はまいえ,はまや
浜崎	はまさき,はまざき
浜上	はまうえ,はまがみ
浜川	はまかわ,はまがわ
浜谷	はまたに,はまや
浜端	はまはた,はまばた
浜地	はまじ,はまち,はまぢ
浜島	はましま,はまじま
浜畑	はまはた,はまばた
不二門	ふじかど,ふじと
富髙	とみたか,とみたけ
富家	とみいえ,とみや,ふけ
富樫	とかし,とがし,とみかし,とみがし
富貴塚	ふきつか,ふきづか
富久田	とみくだ,ふくだ
富居	とみい,ふごう
富崎	とみさき,とみざき,とみづき
富山	とみやま,とやま
富士原	ふじはら,ふじわら
富所	とどころ,とみしょ,とみどころ
富森	とみのもり,とみもり
富沢	とみさわ,とみざわ
富谷	とみたに,とみや
富張	とばり,とみはり,とみばり
富塚	とづか,とみずか,とみつか,とみづか
富田	とみた,とみだ
富島	とみしま,とみじま
富来	とみき,とみく
富和	とみわ,ふわ
富澤	とみさわ,とみざわ
冨岡	とみおか,とみをか
冨家	とみいえ,とみけ,ふけ
冨山	とみやま,とやま
冨士原	ふじはら,ふじわら
冨倉	とみくせ,とみくら
冨沢	とみさわ,とみざわ
冨塚	とみずか,とみつか,とみづか
冨田	とだ,とみた,とみだ,とんだ
冨部	とみべ,とんべ
冨木田	ふきた,ふきだ
冨澤	とみさわ,とみざわ
布浦	ぬのうら,ふうら
布施川	ふせかわ,ふせがわ
布施木	ふせき,ふせぎ
布上	ぬのうえ,ぬのかみ,ぬのがみ
布川	ぬのかわ,ふかわ
布谷	ぬのたに,ぬのや
布田	ぬのた,ふた,ふだ
布野	ぬの,ふの
布留川	ふるかわ,ふるがわ
敷地	しきじ,しきち
敷田	しきた,しきだ
浮気	うき,うきぎ
浮穴	うきあな,うけな
浮川	うきかわ,うきがわ
浮田	うきた,うきだ
譜久山	ふくや,ふくやま
附田	つきた,つきだ,つくた,つくだ
武	たけ,たけし
武衛	たけえ,ぶえい
武笠	たけかさ,たけがさ,むかさ
武居	たけい,たけすえ
武崎	たけさき,たけざき
武市	たけいち,たけち
武鹿	たけしか,ぶしか
武者小路	むしゃこうじ,むしゃのこうじ
武上	たけうえ,たけがみ
武城	たけしろ,ぶじょう
武生	たきゅう,たけお
武川	たけかわ,ぶかわ,むかわ
武谷	たけたに,たけや
武中	たけなか,ぶなか
武田	たけた,たけだ
武藤	たけとう,たけふじ,ぶとう,むとう
武内	たけうち,たけのうち,ぶない
武南	たけなみ,たけみなみ
武馬	たけま,ぶま
武富	たけとみ,たけどみ
武野	たけの,むの
舞田	まいた,まいだ
舞木	まいき,もうぎ
蕪山	かばやま,かぶやま
蕪木	かぶき,かぶらき,かぶらぎ
部谷	とりや,へや
部田	とりた,とりだ,へた
風岡	かざおか,かぜおか
風早	かざはや,かぜはや
風谷	かざたに,かぜたに
風能	ふうの,ふうのう
風本	かざもと,かぜもと
伏屋	ふしや,ふせや
伏間	ふしま,ふすま
伏谷	ふしたに,ふしや,ふせたに
伏木	ふしき,ふせぎ
副島	そえじま,ふくしま
幅崎	はばさき,はばざき
幅上	はばうえ,はばがみ
服巻	はらまき,ふくまき
服藤	はらふじ,ふくとう
福﨑	ふくさき,ふくざき
福羽	ふくは,ふくば
福栄	ふくえ,ふくえい
福家	ふくや,ふけ
福海	ふくうみ,ふくみ
福垣内	ふくがいち,ふくがうち
福崎	ふくさき,ふくざき
福住	ふくすみ,ふくずみ
福所	ふくしょ,ふくしよ
福川	ふくかわ,ふくがわ
福増	ふくまし,ふくます
福代	ふくしろ,ふくよ
福谷	ふくたに,ふくや
福仲	いしみね,ふくなか
福田	ふくた,ふくだ
福島	ふくしま,ふくま
福藤	ふくとう,ふくふじ
福馬	ふくば,ふくま
福迫	ふくさく,ふくさこ,ふくざこ
福来	ふくぎた,ふくらい
福里	ふくさと,ふくざと
福留	ふくとめ,ふくどめ
福澤	ふくさわ,ふくざわ
淵上	ふちかみ,ふちがみ
淵沢	ふちさわ,ふちざわ
淵田	ふちた,ふちだ
物袋	もって,もつて
物部	もののべ,ものべ
鮒子田	ふした,ふしだ
分山	わきやま,わけやま
分田	ぶんだ,わけた,わけだ
分銅	ふんどう,ぶんどう
分目	わけめ,わんめ
粉川	こかわ,こがわ,こなかわ
文	あや,かざり
文山	ふみやま,ぶんやま
文字	もじ,もんじ
文野	ふみの,ぶんの
兵東	ひょうとう,ひょうどう
平	たいら,ひら
平安山	ひらやま,へいあんざん,へんざん
平安名	へいあんな,へんな
平永	ひらえ,ひらなが
平河内	ひらこうち,ひらこうぢ
平賀	ひらか,ひらが
平垣内	ひらかきうち,ひらがいち,ひらがきうち,ひらごうち
平間	ひらま,へいま
平舘	たいらだて,ひらたて,ひらだて
平櫛	ひらくし,ひらぐし
平栗	ひらくり,ひらぐり
平郡	ひらぐん,ひらごおり,へいぐん,へぐり
平形	ひらかた,ひらがた
平原	ひらはら,ひらばら
平戸	ひらと,ひらど
平光	ひらこう,ひらみつ
平口	ひらくち,ひらぐち
平子	たいらこ,ひらこ
平出	ひらいで,ひらで
平城	ひらき,ひらぎ,ひらじょう
平生	ひらお,ひらばえ,へいぜい
平船	たいらぶね,ひらふね
平谷	ひらたに,ひらや
平地	ひらち,へいち
平中	たいなか,ひらなか
平島	ひらしま,ひらじま,へいしま
平等	たいら,ひらとう,びょうどう
平藤	ひらとう,ひらふじ
平馬	ひらま,へいま
平畠	ひらはた,ひらばたけ
平敷	へいしき,へしき
平木	ひらき,ひらぎ
平良	たいら,ひらよし
平澤	ひらさわ,ひらざわ
柄谷	えたに,からたに
柄本	えのもと,えもと,つかもと
柄木田	かたきだ,からきた
並河	なびか,なみかわ
米	こめ,よね
米井	こめい,よねい
米岡	こめおか,よねおか
米屋	こめや,よねや
米家	こめいけ,よねや
米花	べいか,よねか,よねはな
米原	よねはら,よねばら
米崎	よねさき,よねざき
米須	こめす,よねす
米多比	めたひ,めたび
米谷	こめたに,まいたに,まいや,よねたに,よねや
米津	よねず,よねつ,よねづ
米田	こめだ,まいた,まいだ,よねた,よねだ
米島	こめしま,よねしま,よねじま
米内山	よないやま,よなやま
米納	こめの,こめのう,よのう
米本	よなもと,よねもと
米野	こめの,めの,よねの
米里	よねさと,よねざと
別宮	べっく,べつく,べつみや
別枝	べっし,べつし
別府	べっぷ,べふ
別役	べっちゃく,べつちゃく,べつちやく,べつやく
片貝	かたかい,かたがい
片寄	かたよせ,かたより
片境	かたさかい,かたざかい
片桐	かたきり,かたぎり
片上	かたかみ,かたがみ
片川	かたかわ,かたがわ
片谷	かたたに,かたや
片田	かたた,かただ
片淵	かたふち,かたぶち
片木	かたき,かたぎ
片野坂	かたのさか,かたのざか
片渕	かたふち,かたぶち
辺泥	ぺて,ぺてい
辺田	へた,へだ
保	じんぼ,たもつ
保浦	ほうら,ほぼ,やすうら
保栄茂	びん,ほえも
保永	ほなが,やすなが
保延	ぬかのぶ,ほのべ
保月	ほつき,ほづき
保原	ほばら,やすはら
保高	ほたか,ほだか
保崎	ほさき,ほざき
保正	ほうしょう,ほしょう
保積	ほずみ,ほづみ
保川	ほかわ,やすかわ
保泉	ほいずみ,ほずみ
保倉	ほくら,やすくら
保谷	ほうや,ほたに
保地	ほじ,ほち,やすじ
保田	ほた,ぼうだ,やすだ
保土田	ほとだ,ほどた
保尾	ほお,やすお
保富	ほとみ,やすとみ
保木	ほうき,ほき,ほぎ,やすき
保立	ほたち,ほたて
保良	ほら,やすら
穂苅	ほかり,ほがり
穂戸田	ほとた,ほとだ
穂崎	ほさき,ほざき
穂積	ほずみ,ほつみ,ほづみ
穂束	ほつか,ほづか
母倉	ははくら,ぼそう
母里	ぼり,もり
宝井	たからい,ほうじょう
宝居	たからい,ほうきょ
宝珠山	ほうしゅやま,ほうじゅやま
宝田	たからだ,ほうだ
宝迫	ほうさこ,ほうせこ
峰田	みねた,みねだ
峰島	みねしま,みねじま
峯島	みねしま,みねじま
法華津	ほけつ,ほけづ,ほっけづ
法橋	ほうきょう,ほっきょう
法元	ほうが,ほうもと
法師人	ほうしと,ほしと
法水	のりみず,ほうすい
法木	のりき,ほうき,ほうぎ
法澤	のりざわ,ほうざわ
縫田	ぬいた,ぬいだ
芳ヶ迫	ほうがさこ,ほがさこ,よしがさこ
芳原	ほうはら,ほうばら,よしはら
蓬田	あいだ,よもぎた,よもぎだ
蜂谷	はちたに,はちや
豊	ぶんの,ゆたか
豊浦	とようら,とよら
豊岳	とよたけ,ほうがく
豊住	とよすみ,とよずみ
豊城	とよき,とよしろ
豊沢	とよさわ,とよざわ
豊田	とよた,とよだ
豊島	てしま,としま,とよしま
豊嶋	てしま,としま,とよしま
豊里	とよさと,とよざと
豊留	とよとめ,とよどめ
飽田	あきた,あくた
鳳	おおとり,ほう
坊農	ぼうの,ぼうのう
房	ふさ,ぼう
房野	ふさの,ぼうの
望月	もちずき,もちづき
望主	もちぬし,もとぬし
鉾立	ほこたて,ほこだて
北角	きたかく,きたかど,きたずみ
北郷	きたごう,ほくごう,ほんごう
北後	きたご,ほくご
北向	きたむかい,きたむき
北崎	きたさき,きたざき
北所	きたじょ,きたどころ
北上	きたうえ,きたかみ,きたがみ,きたじょう
北城	きたしろ,きたじょう,ほうじょう
北須賀	きたすか,きたすが
北川	きたかわ,きたがわ,きてがわ
北代	きたしろ,きただい
北谷	きたたに,きただに,きたや
北地	きたじ,きたち
北爪	きたつめ,きたづめ
北島	きたしま,きたじま
北嶋	きたしま,きたじま
北迫	きたさこ,きたざこ
北畑	きたはた,きたばた
北方	きたかた,きたがた,ほっぽう
北堀	きたほり,きたぼり
北門	きたかど,きたもん
北里	きさたと,きたさと,きたざと
北條	きたじょう,ほうじょう
墨谷	すみたに,すみや
朴	すなお,ほう,ぼく
朴谷	ほうのきだに,ほおのきだに
朴木	ふのき,ほうのき,ほおのき
朴澤	ほうざわ,ほおざわ
牧角	まきすみ,まきずみ
牧戸	まきと,まきど
牧川	まきかわ,まきがわ
牧谷	まきたに,まきや
牧田	まきた,まきだ
牧島	まきしま,まきじま
睦田	むつた,むつだ
堀家	ほりけ,ほりや
堀金	ほりかね,ほりがね
堀込	ほりこみ,ほりごめ
堀次	ほりつぎ,ほりつぐ
堀上	ほりかみ,ほりがみ
堀切川	ほっきりがわ,ほりきりがわ
堀谷	ほりたに,ほりや
堀端	ほりはた,ほりばた
堀田	ほった,ほつた,ほりた
堀米	ほりごめ,ほりまい
本屋敷	ほんやしき,もとやしき
本家	ほんけ,もといえ
本宮	ほんぐう,もとみや
本居	もとい,もとおり
本元	ほんがん,ほんもと
本江	ほんえ,ほんご,ほんごう,もとえ
本崎	もとさき,もとざき
本宿	ほんしゅく,ほんじゅく,もとしゅく
本庶	ほんしょ,ほんじょ
本庄	ほんしょう,ほんじょう
本図	ほんず,もとず
本川	ほんかわ,ほんがわ,もとかわ
本泉	ほんずみ,もといずみ
本村	ほんむら,もとむら
本多	ほんた,ほんだ
本沢	ほんさわ,ほんざわ,もとざわ
本谷	ほんたに,ほんや,もとたに,もとや
本地	ほんじ,もとち
本仲	ほんなか,もとなか
本津	ほんず,ほんつ,ほんづ
本島	もとしま,もとじま
本東	ほんとう,ほんどう
本波	ほんなみ,もとなみ
本梅	もとうめ,もとめ
本白水	もとしらみず,もとしろみず
本部	ほんぶ,ほんべ,もとぶ
本並	ほんなみ,もとなみ
本保	ほんぼ,ほんぽ,もとやす
本母	ほのぶ,ほんぼ
本末	ほんまつ,もとすえ
本澤	ほんざわ,もとざわ
盆子原	ぼんこはら,ぼんこばら
麻植	あさうえ,おうえ,おえ
麻生	あさお,あさぶ,あそ,あそう
麻畠	あさはた,あさばたけ
麻里	あさり,まり
埋樋	うずんべ,うめどい
妹川	いもかわ,いもがわ
妹尾	せお,せのう,せのお,せのを
毎熊	まいくま,まいぐま
毎田	まいた,まいだ
槙田	まきた,まきだ
槙島	まきしま,まきじま
桝谷	ますたに,ますや
又賀	またか,またが
又川	またかわ,またがわ
末永	すえなが,まつえ
末崎	すえざき,まつざき
末次	すえつぎ,すえつぐ
末田	すえた,すえだ
末藤	すえとう,すえふじ
万井	まんい,よろずい
万羽	ばんば,まんば
万歳	ばんざい,まんざい
万寿	ます,まんじゅ
万城目	まきめ,まんきめ,まんじょうめ
万代	ばんだい,まんだい
万波	まんなみ,まんば
満岡	まおか,みつおか
満恵川	まえかわ,まえがわ
満生	まんしょう,みついき
満田	みつた,みつだ
満木	まき,みつき
満留	みつとめ,みつどめ
味山	あじやま,みやま
味村	あじむら,みむら
味田	あじた,みた
味方	あじかた,みかた
味木	あじき,あまき,みき
箕口	みぐち,みのぐち
箕田	みた,みのだ
箕野	みいの,みの
湊屋	みなとや,みやとや
湊谷	みなとだに,みなとや
蓑谷	みのたに,みのや
蓑田	みのた,みのだ
民谷	たみたに,たみや
無量井	むりょうい,むろい
霧生	きりう,きりゅう
椋田	むくた,むくだ
名井	ない,みょい,みょうい
名越	なこし,なごえ,なごし,なごや
名原	なはら,なばら
名古	なこ,なご
名子	なこ,なご
名須川	なすかわ,なすがわ
名生	なおい,みょう,みよう
名川	なかわ,ながわ
名倉	なくら,なぐら
名渡山	なとやま,などやま
名波	ななみ,なば
名畑	なはた,なばた
命尾	めいお,めお
明	あかり,あきら,あけ,みょう
明井	あかい,あけい,みょうい
明永	あきなが,あけなが
明楽	あきら,あけら,みょうらく
明翫	みょうかん,みょうがん
明吉	あきよし,あけよし,みよし
明見	あけみ,みょうけん
明元	あきもと,あけもと
明坂	あきさか,あけさか
明崎	あかさき,あきざき,あけさき,あけざき
明山	あきやま,あけやま
明松	あけまつ,かがり
明照	みょうしょう,めいしょう
明上	あけがみ,みょうじょう
明瀬	あかせ,あきせ,みょうせ,みよせ
明星	あけほし,あけぼし,みょうじょう,みょうせい
明石	あかいし,あかし,みょういし
明谷	あけたに,あけや
明地	あけち,みょうち,めうち
明智	あかち,あけち,めいち
明珍	みょうちん,みょおちん
明槻	あかつき,あきづき
明庭	あけにわ,みょうば
明田	あきた,あきだ,あけた,あけだ,あげた
明島	あけしま,あけじま
明日	あけひ,ぬくい
明比	あけひ,あけび
明尾	あけお,めお
明歩谷	みょうぶたに,みょうぶだに
明里	あかり,あけり
明和	みょうわ,めいわ
明樂	あきら,あけら
銘苅	めかり,めかる
免田	めんた,めんだ,めんで
綿引	わたひき,わたびき
綿谷	わたけ,わたたに,わたや
綿木	わたき,わたぎ
面	おもて,ほうつき
面髙	おもたか,おもだか
面高	おもたか,おもだか
面谷	おもだに,めんたに,めんや
面田	おもだ,めんだ
面来	おもらい,めんらい
茂見	しげみ,もみ
茂原	しげはら,もはら
茂出木	もでき,もでぎ
茂泉	しげいずみ,もいずみ
茂村	しげむら,もむら
茂中	しげなか,もなか
茂庭	しげにわ,もにわ
茂田	しげた,もだ
茂木	もき,もぎ,もてき,もてぎ
茂利	もうり,もり
茂里	しげり,もり
毛井	けい,もうい
毛受	めんじゅ,めんじょう
網﨑	あみさき,あみざき
網家	あみいえ,あみや
網干	あぼし,あみほし
網崎	あみさき,あみざき
網代	あじろ,あみしろ
網谷	あみたに,あみや
網塚	あみつか,あみづか
網島	あみしま,あみじま,つなしま
木下	きした,きのした
木花	きはな,きばな,このはな
木滑	きなめ,きなめり
木久	ききゅう,きひさ
木宮	きのみや,きみや
木橋	きはし,きばし
木根	きね,きのね
木崎	きさき,きざき
木子	きこ,きご
木寺	きてら,きでら,こでら
木次	きつぎ,こつぎ
木住野	きしの,きずみの
木上	きがみ,きのうえ
木場	きば,こば
木森	きもり,こもり
木積	こずみ,こづみ
木川	きかわ,きがわ
木船	きふね,きぶね
木造	きつくり,きづくり,こづくり
木多	きた,きだ
木代	きしろ,きのしろ
木沢	きざわ,もくざわ
木谷	きたに,きだに,きや,こたに
木地	きじ,きぢ
木津	きず,きつ,きづ
木塚	きずか,きづか
木庭	きにわ,こば
木田	きた,きだ,ぼくだ
木島	きしま,きじま,このしま
木嶋	きしま,きじま
木藤	きとう,きどう,きふじ
木内	きうち,きない,きのうち
木南	きなみ,きなん,きみなみ,こみなみ
木幡	きはた,きばた,こはた,こばた,こわた
木畑	きはた,きばた
木皮	きかわ,きがわ
木尾	きお,このお
木付	きつき,きづき
木附	きつき,きづき
木平	きひら,このひら
木暮	きぐれ,こくれ,こぐれ
木方	きかた,きほう
木目田	きめた,きめだ
木野田	きのた,きのだ
木葉	きば,このは
木嵜	きざき,こざき
木澤	きさわ,きざわ
目	さかん,さがん,さっか
目﨑	めさき,めざき
目加田	めかた,めかだ
目見田	めみた,めみだ
目崎	めさき,めざき
目時	めとき,めどき
目取真	めとりま,めとるま,めどるま
目代	めだい,もくだい
目谷	めたに,めや
餅田	もちた,もちだ
籾谷	もみたに,もみや
門	かど,もん
門家	かどや,もんや
門垣	かどかき,かどがき
門叶	とかない,とが
門間	かどま,もんま
門戸	かど,もんと
門口	かどぐち,もんぐち
門司	もじ,もんじ
門上	かどかみ,かどがみ
門川	かどかわ,もんかわ
門前	かどさき,もんぜん,もんまえ
門谷	かどたに,もんたに
門長	かどなが,もんなが
門田	かどた,もんた,もんだ,もんでん
門木	かどき,もんぎ
門野	かどの,もんの
門矢	かどや,もんや
門林	かどばやし,もんばやし
野	とぎの,の
野﨑	のさき,のざき
野々上	ののうえ,ののがみ
野々川	ののかわ,ののがわ
野下	のげ,のした
野家	のいえ,のえ
野開	のひらき,のびらき
野角	のかく,のがく,のずみ
野間口	のまくち,のまぐち
野間田	のまた,のまだ
野宮	ののみや,のみや
野牛	のうし,やぎゅう
野橋	のはし,のばし
野坂	のさか,のざか
野阪	のさか,のざか
野崎	のさき,のざき
野手	のて,ので
野住	のすみ,のずみ
野小生	のおも,のもお
野上	のかみ,のがみ
野城	のぎ,のしろ,やしろ
野生須	のうす,のおす
野倉	のくら,のぐら
野代	のしろ,のだい
野谷	のたに,のや
野地	のじ,のち,のぢ
野津	のつ,のづ
野底	のか,のそこ
野藤	のとう,のふじ
野頭	のず,のづ
野内	のうち,やない
野畑	のはた,のばた
野平	のだいら,のひら,のびら
野方	のかた,のがた
野北	のきた,のぎた
野毛	のげ,のも
野呂田	のろた,のろだ
野路	のじ,のろ
弥永	いやなが,やなが
弥富	いやとみ,いやどみ,やとみ
矢﨑	やさき,やざき
矢延	やのぶ,やのべ
矢橋	やはし,やばし,やばせ
矢形	やかた,やがた
矢原	やはら,やばら
矢後	やご,やごう
矢崎	やさき,やざき
矢作	やさく,やはぎ
矢寺	やてら,やでら
矢上	やかみ,やがみ
矢城	やぎ,やしろ
矢数	やかず,やす
矢川	やかわ,やがわ
矢倉	やくら,やぐら
矢代	やしろ,やだい
矢谷	やがい,やたに
矢竹	やたけ,やだけ
矢津	やず,やづ
矢田	やた,やだ
矢島	やしま,やじま
矢頭	やず,やとう
矢内	やうち,やない
矢納	やの,やのう
矢幡	やはた,やわた
矢富	やとみ,やどみ
矢方	やかた,やのほ
矢満田	やまだ,やまんた
矢留	やとめ,やどめ
役田	やくた,やくでん
柳	やなぎ,りゅう
柳井	やない,やなぎい
柳浦	やぎうら,やなうら
柳下	やぎした,やなぎした,やなした
柳楽	なぎら,やぎら
柳舘	やなぎたて,やなぎだて
柳橋	やぎはし,やなぎはし,やなぎばし,やなはし
柳原	やなぎはら,やなぎわら
柳森	やなぎもり,やなもり
柳瀬	やなぎせ,やなせ
柳生	やぎう,やぎゅう
柳川	やながわ,やなぎかわ
柳曽	やなぎそ,やなそ
柳村	やなぎむら,やなむら
柳谷	やなぎたに,やなぎだに,やなぎや
柳田	やぎた,やなぎた,やなぎだ,やなだ
柳内	やぎうち,やない,やなうち,やなぎうち
柳父	やぎゅう,やなぶ
柳平	やなぎだいら,やなひら
柳堀	やなぎほり,やなぎぼり,やなほり
柳本	やぎもと,やなぎもと,やなもと
柳野	やなぎの,やの
薮口	やぶくち,やぶぐち
薮内	やぶうち,やぶのうち
油井	あぶらい,ゆい
油橋	ゆはし,ゆばし
油座	あぶらざ,ゆざ
油石	あぶらいし,ゆうせき
油谷	あぶらたに,あぶらや,ゆたに,ゆや
油津	ゆず,ゆづ
油田	あぶらた,あぶらだ,ゆた,ゆだ
油本	あぶらもと,ゆもと
油木	あぶらき,ゆうき,ゆき
油野	あぶらの,ゆの
勇	いさみ,いさむ
友延	とものぶ,とものべ
友寄	ともよせ,ともより
友金	ともかね,ともがね
友崎	ともさき,ともざき
友枝	ともえ,ともえだ
友次	ともつぎ,ともつぐ
友住	とみずみ,ともずみ
友谷	ともたに,ともや
友田	ともた,ともだ
友利	ともとし,ともり
友澤	ともさわ,ともざわ
有屋田	ありやた,ありやだ
有家	ありいえ,ありか,ありけ,ありや
有賀	ありが,あるか,あるが
有海	ありうみ,ありかい,ありみ
有隅	ありすみ,ありずみ
有光	ありこう,ありみつ
有住	ありすみ,ありずみ
有上	ありうえ,ありがみ
有水	ありみず,うすい
有澄	ありすみ,ありずみ
有生	ありせ,ありそ
有倉	ありくら,ゆうくら
有谷	ありたに,ありや
有地	ありち,ありぢ
有藤	ありとう,ありふじ
有働	うどう,ゆうどう
有得	ありえ,ありとく
有富	ありとみ,ありどみ
有冨	ありとみ,ありどみ
有墨	ありすみ,ありずみ
有木	あらき,ありき
有留	ありとめ,ありどめ
有路	ありじ,あるじ
柚原	ゆずはら,ゆはら
柚木	ゆうき,ゆうのき,ゆうぼく,ゆき,ゆずき,ゆのき
柚木園	ゆきぞの,ゆのきぞの
湧川	わきかわ,わきがわ,わくかわ,わくがわ
湧田	わきた,わくた,わくだ
涌田	わくた,わくだ
由井	ゆい,よしい
由上	ゆかみ,よしがみ
由谷	ゆたに,よしたに
由地	ゆち,ゆぢ
由比	ゆい,ゆひ
由本	ゆもと,よしもと
由木	ゆうき,ゆき,ゆぎ
祐川	すけかわ,すけがわ
祐田	すけた,ゆうだ
遊座	ゆうざ,ゆざ
遊田	あそだ,ゆうだ
雄谷	おうや,おおや,おたに,おや
余頃	よころ,よごろ
余田	よだ,よでん
与世田	よこだ,よせだ
与田	よだ,よでん
誉田	こんだ,ほまれだ,ほんだ
輿	こし,はじ
揚田	あがりた,あげた
楊	やなぎ,やん,よう
楊井	やぎい,やない
用田	もちだ,ようだ
葉田	はた,はだ
要田	かなめだ,ようだ
要藤	ようとう,ようどう
陽	みなみ,よう
養父	やぶ,ようふ
浴本	えきもと,よくもと
淀川	よどかわ,よどがわ
淀谷	よどたに,よどや
来海	きまち,らいかい
来間	くりま,くるま
来迎	らいこう,らいごう
来住	きし,きずみ,らいじゅう
来村	きたむら,きむら
来代	きたしろ,きただい
来田	きた,きただ,きだ,くるた,らいた,らいだ
来島	きじま,くるしま
来嶋	きじま,くるしま
来野	きたの,らいの
頼	より,らい
雷	いかずち,らい
落谷	おちたに,おちや
藍原	あいはら,あいばら
蘭	あらき,あらぎ,あららぎ,らん
利岡	としおか,りおか
利光	としみつ,りこう
利川	とがわ,としかわ
利倉	とくら,としくら,りくら
利谷	とぎや,としたに
利田	かがた,としだ,りた
利野	としの,りの
梨羽	なしは,なしば
裏地	うらじ,うらち
里崎	さとさき,さとざき
陸	くが,りく
陸口	むくち,むぐち
陸田	むつだ,りくた
立	たち,たて
立井	たちい,たてい
立岡	たちおか,たつおか,たておか
立岩	たちいわ,たていわ
立見	たつみ,たてみ
立元	たちもと,たつもと,たてもと
立原	たちはら,たてはら
立光	たつこう,たてみつ
立崎	たちざき,たつざき
立山	たちやま,たつやま,たてやま
立上	たつかみ,たてがみ
立成	たちなり,たつなり
立石	たついし,たていし
立川	たちかわ,たつかわ,たつがわ,たてかわ
立田	たつた,たてだ
立道	たちみち,たつみち,たてみち
立入	たちいり,たていり
立部	たちべ,たてべ
立平	たつひら,たてひら
立堀	たちぼり,たつぼり
立本	たちもと,たつもと,たてもと
立木	たちき,たつき,たつぎ,ついき
立野	たちの,たつの,たての
立浪	たちなみ,たつなみ
立脇	たちわき,たてわき
立澤	たちざわ,たつざわ,たてざわ
流田	ながれた,ながれだ
留守	とめもり,るす
留田	とめた,とめだ
隆	たか,たかし
竜田	たつた,りゅうた
龍	りゅう,りょう
龍渓	たつだに,りゅうたに
龍口	たつぐち,たつのくち
龍治	りゅうじ,りょうじ
龍神	たつがみ,りゅうじん
龍瀬	りゅうせ,りょうせ
龍川	たつかわ,りゅうかわ
龍前	りゅうまえ,りょうまえ
龍村	たつむら,りゅうむら
龍田	たきた,たつた,りゅうた
龍野	たつの,りゅうの
両川	もろかわ,りょうかわ
凌	しのぎ,りょう
梁	やな,りょう
梁取	やなとり,やなどり
良知	らち,りょうち
力石	ちからいし,りきいし
林下	はやしした,りんげ
林原	はやしはら,はやしばら,りんばら
林谷	はやしたに,はやしだに
輪湖	わこ,わご
冷水	しみず,ひやみず,れいすい
嶺崎	みねさき,みねざき
嶺田	みねた,みねだ
鈴木	すすき,すずき,すづき
霊山	かみやま,よしやま
蓮	はす,はちす,れん
蓮子	はすし,はっし,はつし
蓮田	はすだ,よもぎだ
連	むらじ,れん
露﨑	つゆさき,つゆざき
露崎	つゆさき,つゆざき
浪越	なお,なみこし
篭谷	かごたに,こもりや
老月	おいつき,おいづき
老田	おいた,おいだ
六井	むつい,ろくい
六角	むすみ,ろっかく
六山	むやま,ろくやま
六鹿	むしか,むつが,むつしか,ろくしか
六車	むぐるま,ろくしゃ
六川	ろくかわ,ろくがわ
六鎗	むやり,ろくやり
六田	ろくた,ろくだ
六尾	むつお,ろくお
麓	ふもと,ろく
和	なごみ,にぎ
和賀井	わかい,わがい
和気	わき,わけ
和久田	わくた,わくだ
和栗	わくり,わぐり
和崎	わさき,わざき
和山	かずやま,わやま
和泉	いずみ,わいずみ
和泉谷	いずみたに,いずみや
和泉田	いずみた,いずみだ
和地	わじ,わち,わぢ
和田野	わたの,わだの
和島	わしま,わじま
和平	わだいら,わひら,わへい
和氣	わき,わけ
和澤	わさわ,わざわ
脇黒丸	わきくろまる,わきぐろまる
脇坂	わきさか,わきざか
脇阪	わきさか,わきざか
脇川	わきかわ,わきがわ
脇谷	わきたに,わきや
脇地	わきじ,わきぢ
脇田	わきた,わきだ
鷲見	すみ,わしみ
鷲崎	すさき,わしざき
鷲巣	わしず,わしのす
鷲谷	わしたに,わしや
鷲塚	わしずか,わしづか
亘	わたり,わたる
佛坂	ぶっさか,ぶつさか,ほとけざか
佛生	ぶっしょう,ぶっそう
假宿	かりしゅく,かりじゅく
會	あい,かい
會津	あいず,あいづ
會田	あいた,あいだ
會野	あいの,かいの
會澤	あいさわ,あいざわ
傳	つとう,でん
兒玉	かまだ,こだま
劔持	けんもち,けんもつ
剱持	けんもち,けんもつ
圀府寺	こうじ,こうでら
國崎	くにさき,くにざき
國司	くにし,こくし
國場	くにば,こくば
國西	くににし,こくにし
國沢	くにさわ,くにざわ
國田	くにた,くにだ
國藤	くにとう,くにふじ
國頭	くにがみ,くにとう
國府	こう,こお,こくふ,こくぶ
國部	くにべ,こくぶ
國分	こくぶ,こくぶん
國立	くにたて,こくりゅう
國澤	くにさわ,くにざわ
圓井	つむらい,まるい
圓谷	えんたに,つぶやら,つぶらや,つむらや
圓田	えんた,えんだ,まるた
圖師	ずし,づし
圦本	いりもと,ゆりもと
垰本	たおもと,たわもと
垰野	たおの,たをの
壹岐	いき,いつき
壽	ことぶき,としなが
壽崎	すさき,すざき
壽田	すだ,ひさだ
壽藤	じゅとう,すどう
姜	かん,きょう
媚山	こびやま,こやま
實吉	さねよし,みよし
實松	さねまつ,じつまつ
實成	じつなり,みなり
實田	さねだ,じつた,じつだ
實方	さねかた,じつかた
寶田	たからだ,ほうだ
寶來	たからぎ,ほうらい
寳積	ほうしゃく,ほづみ
寳田	たからだ,ほうだ
嶽	たけ,だけ
廣滝	おとわ,ひろたき
廣谷	ひろたに,ひろや
廣長	ひろちょう,ひろなが
廣畠	ひろはた,ひろばた
彌冨	いやとみ,やとみ
應武	おうたけ,おおたけ
拜原	はいはら,はいばら
挾間	はさま,はざま
杼木	とちき,とちぎ
枌	そぎ,へき,へぎ
枋木	こぶのき,こぼのき
枦山	はしやま,はぜやま
檜原	ひはら,ひばら,ひわら
檜谷	ひのきだに,ひのきや,ひのたに
檜田	ひえだ,ひだ,ひのきだ
檮木	うつき,ゆすき
椚田	くにぎだ,くぬぎだ
楜澤	くるみさわ,くるみざわ
楫取	かじとり,かとり
楡木	にれき,にれぎ
楪	ゆずり,ゆずりは
榮	さかい,さかえ
榮原	さかえはら,さかえばら
榮野比	えのひ,えのび
槐	えびす,えんじ,さいかち
榧木	かやき,かやのき
樂	らく,らん
櫃本	ひしもと,ひつもと
櫟	あららぎ,いちい
櫟原	いちはら,ひらはら
檪	あららぎ,いちき
檪本	いちもと,とちもと
櫻川	さくらかわ,さくらがわ
櫻谷	さくらたに,さくらだに,さくらや
欅田	くにぎた,くぬぎた,けやきだ
氣賀澤	きがさわ,けがさわ
氣仙	きせん,けせん
氣谷	きたに,きや
氣田	きだ,けた
渕田	ふちた,ふちだ
淺川	あさかわ,あさがわ
淺木	あさき,あさぎ
湶	あわら,いずみ
滿田	まんだ,みつた
澁谷	しぶたに,しぶや
澤	さわ,やなぎさわ
澤崎	さわさき,さわざき
澤谷	さわたに,さわや
澤地	さわじ,さわち,さわぢ
澤田	さわた,さわだ
澤田石	さわたいし,さわだいし
澤渡	さわたり,さわど
澤登	さわと,さわのぼり
澤武	さわたけ,さわぶ
澤瀉	おもがた,おもだか
濱家	はまいえ,はまや
濱崎	はまさき,はまざき
濱小路	はまこうじ,はましょうじ
濱谷	はまたに,はまや
濱地	はまじ,はまち,はまぢ
濱島	はましま,はまじま
濱畑	はまはた,はまばた
濱里	はまさと,はまざと
當山	とうやま,とおやま
當摩	たいま,とうま
當麻	たいま,とうま,とおま
當銘	とうめ,とうめい
癸生川	きぶかわ,けぶかわ
皀	くろごめ,さいかち
眞井	さない,まい
眞舘	まだち,まだて
眞砂	なまご,まさご
眞城	しんじょう,まき,ましろ
眞島	ましま,まじま
眞道	しんどう,まみち
眞尾	まお,ましお
眞保	しんぼ,しんぽ
礒川	いそかわ,いそがわ
礒谷	いそたに,いそや
礒端	いそはた,いそばた
礒田	いそた,いそだ
齋	いつき,さい
齋田	さいた,さいだ,ときた
笘	おおとま,とま
筧	かけい,かけひ
筧田	といた,といだ
簑田	みのた,みのだ
簑毛	みのけ,みのも
籠谷	かごたに,かごや,こもりや
糀谷	こうじたに,こうじや
綛谷	かせたに,かせや
續	つずき,つつき,つづき
纐纈	あやめ,こうきつ,こうけつ
臺	うてな,だい
與古田	よこた,よこだ
與田	よだ,よでん
舩橋	ふなはし,ふなばし
菴原	いおはら,おいはら
萬	まん,よろず,よろづ
萬井	まんい,よろい
萬喜	まき,まんき
萬上	ばんじょう,まんがみ
萬代	ばんだい,まんだい
萬谷	ばんや,まんたに,まんや,よろずや
萬木	まんき,もろき,ゆるぎ
蓼沼	たてぬま,たでぬま
藪谷	やぶたに,やぶや
藏下	くらした,くらしも
蜷川	になかわ,にながわ
蟇目	ひきめ,ほそごし
譽田	こんだ,ほんだ
釼持	けんもち,けんもつ
鐵	くろがね,てつ
鈩	たから,たたら
雉子谷	きじたに,きじだに
霍田	つるた,つるだ
饒平名	のひな,よへな
鰺坂	あじさか,あぢさか
鶉橋	うずらはし,うずらばし
麥田	あおた,むぎた
齊賀	さいか,さいが
齊信	さいしん,さいのぶ
曻	のぼり,のぼる
桒原	くわはら,くわばら
橳島	ぬでしま,ぬでじま
濵﨑	はまさき,はまざき
鮏川	あゆかわ,すけがわ
