あい	あい,アイ,亜以,亜伊,亜依,亜偉,亜惟,亜維,亜衣,亜莞,亜生,亜唯,亜倭,娃伊,娃依,娃維,娃衣,娃莞,娃冶,阿以,阿依,阿衣,哀,愛,愛以,愛伊,愛依,愛惟,愛維,愛衣,愛郁,愛叶,愛結,愛生,愛泉,愛唯,愛李,愛倭,愛已,挨,逢,逢依,逢衣,逢生,葵衣,茜衣,綾彩,安維,安衣,安生,安唯,安倭,杏伊,杏依,杏衣,杏莞,杏結,杏月,杏色,杏唯,杏倭,杏苺,於,雅易,雅衣,挙衣,吾以,吾惟,吾衣,吾唯,彩以,彩伊,彩依,彩維,彩衣,彩莞,彩生,彩唯,心,心依,美,歩惟,歩唯,明依,明衣,明莞,明彩,明生,唯愛,有依,有惟,有衣,有莞,有泉,藍,藍依,藍維,藍衣,和,和衣,和生,亞委,亞衣,晏莞,曖,曖衣
あいが	あい芽,愛芽,藍芽
あいき	亜依希,愛嬉,愛季,愛琴,愛粋,愛其,愛妃,愛姫,愛李,愛來,愛綺,安粋,杏粋,雅意紀,空愛姫,心絆,藍稀,綺愛姫
あいく	あい玖,亜依玖,愛宮,愛九,愛寓,愛紅,愛心,愛夢,愛唯求,愛來,愛徠,逢空,葵空,絢郁,彩郁,碧空,歩空,明生,藍久,藍紅,藍来,曖玖
あいじ	綾衣,綾衣志,綾衣星,彩衣慈,心衣慈,心衣星,藍慈,藍路
あいと	亜依音,愛乙,蒼月,瞳杜,藍采
あいま	愛天,愛舞,愛眞,愛茉,逢蒔,藍茉
あお	亜桜,亜緒,亜臣,亜青,亜和,愛於,愛欧,愛音,愛桜,愛織,愛想,愛碧,愛穂,愛櫻,逢音,葵愛,絢央,絢欧,絢桜,絢麻,綾央,綾欧,綾桜,杏於,杏央,杏欧,杏桜,杏緒,杏和,雨音,空愛,空於,空生,空櫻,吾緒,彩愛,彩欧,彩音,彩緒,彩水,青色,蒼桜,天愛,碧於,碧乙,碧音,碧桜,歩央,麻緒,明愛,明桜,明青,有音,有緒,和音,和桜,和緒,亞愛,綺愛,綺央,綺欧,綺音,綺桜,綺緒,綺織,綺麻,綺和
あおい	あおい,アオイ,亜央依,亜央已,亜奥以,亜乙依,亜緒依,亜緒維,亜緒衣,亜緒莞,亜捺惟,娃旺伊,娃旺依,娃旺衣,娃桜以,娃桜伊,娃桜衣,愛葵衣,愛衣,愛央伊,愛央李,愛温生,愛音,愛音生,愛音唯,愛結,愛桜,愛桜伊,愛桜彩,愛桜唯,愛桜苺,愛緒衣,愛緒唯,愛織衣,愛生衣,愛碧,愛和,愛和衣,愛和音,愛櫻生,逢欧伊,逢欧衣,逢欧莞,逢欧彩,逢欧泉,逢欧唯,葵ヰ,葵愛,葵偉,葵夷,葵育,葵音,葵彩,葵桜苺,葵泉,葵麻衣,葵癒,葵李,葵苺,絢央衣,絢欧衣,綾欧花,安央以,安央伊,安央意,安央衣,安央彩,安桜以,安桜依,安桜衣,安麻伊,安麻依,安麻衣,庵恩李,杏央以,杏央依,杏央意,杏央衣,杏央彩,杏央唯,杏欧彩,杏乙依,杏桜伊,杏桜依,杏桜花,杏桜彩,杏緒衣,杏麻以,杏麻伊,杏麻衣,夏葵,花桜彩,仰以,仰生,空衣,空央衣,空音衣,空莞,空緒衣,空織衣,空色,空生,向葵,向日葵,紺碧,彩葵,彩央伊,彩央依,彩央泉,彩欧衣,彩音衣,彩桜,彩生伊,彩和衣,采欧衣,若,朱葵,星欧姫,青,青空,青唯,扇,扇以,扇依,爽,蒼尉,蒼桜,蒼似,蒼泉,蒼入,蒼苺,暖央衣,美空,楓葵,碧愛,碧葵,碧位,碧尉,碧慰,碧允,碧空維,碧彩,碧菜,碧色,碧粋,碧生,碧聖,碧蒼瑠,碧天,碧冶,碧優,碧悠,碧容,碧倭,麻央衣,明央衣,明音位,明音惟,明音椅,明音衣,明音井,明音彩,明音唯,明緒伊,明青衣,明尾衣,有生伊,藍衣,藍央衣,藍欧彩,恋桜苺,和愛衣,和音彩,綺音
あおき	亜緒季
あおぞら	葵空
あおば	あおば,あお羽,あお葉,愛王磨,愛乙羽,愛音羽,愛桜葉,愛緒羽,愛生葉,葵央羽,葵華,安奥羽,翠巴,青花,青巴,蒼巴,碧華,明央葉,藍羽
あかし	亜花詞,丹志
あき	あき,アキ,亜器,亜葵,亜喜,亜嬉,亜気,亜祈,亜紀,亜規,亜起,亜紅,亜枝,亜粋,亜生,亜妃,亜姫,亜木,亜来,亜來,亜絆,亜綺,娃葵,娃伎,娃喜,娃岐,娃希,娃祈,娃季,娃稀,娃紀,娃貴,娃輝,娃樹,娃妃,娃姫,娃来,娃來,阿季,阿紀,阿貴,阿生,愛,愛葵,愛衣,愛伎,愛喜,愛嬉,愛希,愛祈,愛季,愛稀,愛紀,愛記,愛貴,愛響,愛琴,愛月,愛幸,愛咲,愛秋,愛心,愛生,愛爽,愛妃,愛姫,愛来,愛來,愛晄,愛絆,愛綺,挨希,逢喜,逢希,逢姫,葵希,葵輝,葵姫,茜希,茜紀,茜姫,梓希,絢葵,絢希,絢祈,絢稀,絢貴,絢樹,絢姫,絢來,絢綺,綾葵,綾希,綾紀,綾樹,綾來,綾綺,安葵,安嬉,安岐,安季,安稀,安輝,安樹,安姫,杏衣,杏岐,杏希,杏祈,杏季,杏稀,杏紀,杏貴,杏輝,杏樹,杏生,杏姫,杏來,杏綺,映,会希,菊,暁葵,暁熙,空喜,空季,空紀,空姫,空來,空絆,空綺,敬,吾喜,吾希,吾季,吾稀,吾記,吾輝,吾城,吾姫,吾木,吾綺,公希,幸,紅季,紅妃,彩葵,彩喜,彩季,彩稀,彩記,彩幸,彩生,彩妃,彩姫,彩來,采葵,燦,朱,朱希,秋希,秋季,秋桜,秋妃,秋来,昌,晶希,晶紀,晶貴,晶輝,章樹,心綺,青月,壮,爽,天希,日,彬希,文,碧希,歩来,泡姫,麻希,麻紀,明黄,明喜,明嬉,明季,明紀,明起,明月,明姫,明来,紋,有花,有喜,有希,有紀,有記,有貴,有輝,有妃,曜,陽希,陽季,陽姫,藍旗,璃希,亮希,諒気,諒祈,諒季,諒綺,和季,晨,綺希
あきお	秋緒,晶緒,明乙,明緒
あきな	あきな,あき奈,あき那,アキナ,亜喜奈,亜希菜,亜希奈,亜希那,亜季菜,亜季奈,亜季那,亜季名,亜季梛,亜稀菜,亜稀七,亜紀菜,亜紀奈,亜貴菜,亜貴奈,亜貴那,亜貴名,亜輝菜,亜輝奈,亜金奈,亜樹奈,亜樹那,亜樹名,亜妃菜,亜姫那,亜姫納,亜綺奈,娃稀奈,愛葵夏,愛葵菜,愛希菜,愛希奈,愛季奈,愛稀奈,愛紀菜,愛貴那,愛輝奈,愛輝那,愛幸凪,愛菜,愛樹菜,愛樹奈,愛生梛,愛奈,愛那,愛凪,愛姫夏,愛姫菜,愛姫奈,愛来,愛綺奈,逢希奈,旭菜,旭奈,旭那,絢希菜,絢季菜,絢季奈,絢季那,安希菜,安希奈,安樹奈,杏樹菜,杏樹奈,映菜,映七,映奈,映那,映南,映名,瑛菜,瑛奈,央奈,輝南,義奈,菊奈,亨菜,亨奈,尭奈,暁菜,暁七,暁奈,暁那,暁捺,暁名,暁和,空夏,空奈,空那,空南,空納,啓夏,啓七,啓那,啓納,啓名,光菜,光凪,幸凪,幸和,晃菜,晃七,晃奈,晃那,晃凪,晃南,彩嬉梛,彩希菜,彩希那,彩季菜,燦夏,燦菜,燦渚,燦奈,燦那,燦凪,燦南,燦名,燦梛,朱希菜,秋愛,秋菜,秋七,秋声,秋奈,秋那,秋凪,秋南,秋名,秋来,秋梨,秋梛,淳奈,商,彰愛,彰菜,彰奈,彰梛,昌奈,昌那,昭名,晶希菜,晶紀菜,晶紀奈,晶菜,晶奈,晶那,祥菜,章夏,章菜,章七,章奈,章那,章納,章名,翠菜,翠七,翠奈,翠那,翠凪,翠梛,爽奈,爽那,爽梛,聡菜,旦生,知奈,知那,朝希菜,日月奈,彬菜,彬那,彬名,彬梛,明夏,明喜奈,明希菜,明希奈,明希南,明希来,明季奈,明菜,明樹奈,明奈,明那,明凪,明南,明納,明姫奈,明名,明梛,有希那,有希凪,有季菜,有季奈,有季凪,有樹凪,耀夏,耀菜,耀雫,耀奈,耀那,陽夏,陽懐,陽菜,陽渚,陽奈,陽那,陽凪,陽捺,陽南,陽名,陽和,陽梛,璃愛,璃夏,璃菜,璃七,璃渚,璃生,璃奈,璃那,璃凪,璃南,璃楠,璃名,璃梛,亮菜,亮奈,亮那,亮南,亮名,諒夏,諒菜,諒七,諒奈,諒南,諒納,諒名,玲奈,礼夏,礼菜,礼雫,礼七,礼渚,礼奈,礼納,礼名,露夏,露菜,露奈,露那,和凪,晄奈,燿夏
あきひ	亜希日,亜希妃,亜希比,亜希陽,亜季日,亜季妃,亜季比,亜季陽,亜紀日,亜紀妃,亜紀比,亜紀陽,亜貴日,亜貴妃,亜貴比,亜貴陽,亜樹日,亜樹妃,亜樹比,亜樹陽,愛生日,愛生妃,愛生比,愛生陽,愛日,映柊,啓灯,啓陽,彩姫日,彩姫妃,彩姫比,彩姫陽,秋日,秋妃,秋比,秋柊,秋陽,彰日,彰妃,彰比,彰陽,晶日,晶妃,晶比,晶柊,明希日,明希妃,明希比,明希陽,明日,明妃,明比,明柊,明来柊,有紀日,有紀妃,有紀比,有紀陽
あきら	亜葵蘭,亜稀羅,亜姫良,阿吉良,愛稀羅,愛紀良,愛輝,愛金来,愛星,愛生煌,愛姫羅,愛來,愛絆羅,絢姫藍,絢姫蘭,絢姫礼,杏稀羅,卯,映来,映頼,映來,央羅,央頼,央蘭,央來,輝星,郷来,暁空,暁羅,空稀羅,啓来,光羅,光来,光蘭,彩稀羅,秋咲,秋頼,秋麗,秋來,秋徠,秋綺羅,章来,翠羅,翠来,聖瑛,聖星,聡来,天稀羅,瞳,白,緋梨,明星,明頼,明來,紋良,有晃,陽良,璃羅,諒來,玲来,玲頼,玲良,玲來,礼羅,礼頼,礼蘭,礼來,露,露羅,露良,奎,奎良,晄楽,煌羅,煌良,禮
あくあ	亜玖亜,亜空愛,亜空彩,亜空歩,亜紅愛,亜来阿,愛海,愛九亜,愛夢空,愛來,葵紅曖,葵来愛,葵来空,杏空愛,海,海玖亜,海來愛,開愛,空々,空愛,空絢,空吾,空夢愛,心音愛,水,水愛,水色,青空青,蒼玖亜,萌愛,明亜,明愛,明来愛,明來愛,藍空愛,亞久亞,曖空杏
あさ	あさ,アサ,亜佐,亜沙,亜砂,亜彩,亜咲,亜桜,亜紗,亜茶,娃佐,娃沙,娃瑳,娃砂,娃冴,娃咲,娃早,阿佐,阿沙,阿砂,阿咲,阿紗,愛彩,愛冴,愛咲,愛紗,逢紗,旭,絢彩,絢咲,安沙,安彩,安咲,安紗,杏咲,雨桜,空佐,空沙,空彩,空咲,空紗,彩佐,彩沙,彩冴,彩咲,彩桜,彩紗,彩早,彩朝,采冴,心咲,心紗,旦,朝,朝咲,麻,麻咲,麻紗,明佐,明沙,明彩,明冴,明咲,明桜,明紗,有沙,有咲,有紗,和彩,和咲,和紗
あさき	あさき,亜沙希,亜咲葵,亜紗葵,亜紗希,亜紗季,亜岬,阿沙妃,愛郷,愛幸,愛佐紀,愛沙希,愛沙紀,愛沙貴,愛沙樹,愛沙生,愛沙来,愛咲,愛咲希,愛咲紀,愛咲姫,愛桜咲,愛桜樹,愛桜姫,愛紗希,愛紗季,愛先,愛早希,愛早紀,愛早妃,葵咲,旭姫,安咲,安咲妃,安桜記,杏咲,晃咲,彩咲,彩咲季,采咲,晶咲,心咲,朝紀,朝咲,朝木,天紗希,日葵,麻季,麻咲,麻生,麻姫,麻木,明咲,有咲,有紗姫,藍咲,和咲
あさぎ	愛如月,翠輝,浅黄,浅姫,朝衣,朝霧,麻葵
あさと	あさと,愛郷,愛暁,愛慧,愛咲里,愛桜里,愛里,杏咲十,杏里,麻渡,明聖,有桜巴
あさは	あさ葉,愛咲葉,彩桜巴,彩巴,旦羽,旦波,朝羽,朝巴,朝琶,麻羽,麻巴,麻琶,麻芭,麻葉,明咲葉
あさひ	あさひ,あさ妃,亜佐飛,亜沙妃,亜沙桧,亜瑳緋,亜咲日,亜咲妃,亜咲陽,亜桜妃,亜紗妃,亜紗比,娃沙陽,娃咲陽,阿沙緋,愛沙燈,愛桜妃,愛飾姫,逢紗陽,葵咲光,葵咲日,葵咲姫,旭妃,安沙緋,安咲妃,安紗斐,杏佐日,杏佐飛,杏佐柊,杏咲陽,空沙陽,彩梓,彩幸陽,彩沙妃,彩咲緋,彩咲陽,彩桜陽,彩紗妃,彩紗陽,彩飛,采冴陽,旦妃,日月日,碧比,歩宙,麻灯,麻妃,麻姫,麻弥,明咲,明桜妃,明紗妃,明早陽,有沙陽,有咲日,有咲陽,有桜飛,有紗日,有紗妃,有紗姫,有紗陽,陽心,諒柊,曖早陽
あした	愛志多
あしゅ	亜朱,愛朱,愛珠,杏朱,杏珠
あす	娃守,娃須,愛守,愛翠,空澄,空優,吾守,未来
あすか	あすか,あす佳,あす果,あす花,あす華,あす香,アスカ,亜沙加,亜朱夏,亜朱荷,亜朱華,亜朱香,亜珠花,亜寿伽,亜寿佳,亜寿加,亜寿嘉,亜寿夏,亜寿果,亜寿架,亜寿歌,亜寿花,亜寿華,亜寿賀,亜寿香,亜春香,亜須伽,亜須佳,亜須嘉,亜須夏,亜須果,亜須架,亜須歌,亜須花,亜須華,亜須賀,亜須香,亜須日,亜須耶,亜澄佳,亜澄加,亜澄夏,亜澄果,亜澄花,亜澄華,亜澄香,亜澄翔,亜透,亜日歌,阿寿楓,阿須華,愛花,愛華,愛空,愛好香,愛咲華,愛守姫,愛朱架,愛朱華,愛朱香,愛珠華,愛珠翔,愛寿伽,愛寿佳,愛寿加,愛寿可,愛寿嘉,愛寿夏,愛寿果,愛寿架,愛寿歌,愛寿花,愛寿華,愛寿賀,愛寿香,愛寿日,愛洲香,愛春香,愛須伽,愛須佳,愛須加,愛須嘉,愛須夏,愛須果,愛須架,愛須歌,愛須花,愛須華,愛須賀,愛須香,愛須日,愛雛神,愛澄華,愛澄香,愛日香,安珠伽,安珠香,安寿華,安寿香,安栖嘉,杏花,杏好花,杏珠夏,杏珠華,杏珠翔,杏寿花,杏寿香,杏鈴星,希香,京佳,彩朱翔,彩珠花,彩珠翔,彩日花,彩日香,朱夏,春画,星珠夏,星珠香,飛烏,飛榎,飛伽,飛佳,飛寡,飛果,飛架,飛歌,飛花,飛樺,飛香,飛鳥花,飛島,飛日夏,未来架,未来歌,未来花,未来香,明伽,明佳,明可,明夏,明河,明花,明華,明霞,明空,明好加,明香,明寿佳,明寿花,明寿香,明須香,明澄佳,明澄夏,明澄架,明澄花,明澄華,明澄香,明奏,明日,明日榎,明日伽,明日果,明日架,明日禾,明日海,明日叶,明日輝,明日圭,明日楓,明日風,明日耶,明日珈,明楓,有沙香,有珠夏,有寿華,有寿香,有友加,陽佳,陽加,陽嘉,陽夏,陽果,陽架,陽歌,陽珂,陽花,陽華,陽芽,陽雅,陽香,陽代,陽耶,陽蘭,翌佳,藍洲柑,流星,翔嘉
あず	あず,亜沙,亜珠,亜寿,亜鶴,阿珠,愛珠,愛寿,愛鶴,逢瑞,葵寿,梓,絢寿,安珠,安寿,杏珠,杏寿,空珠,空寿,彩珠,彩寿,紫珠,朱珠,明珠,有珠,和珠,和寿
あずま	梓舞,梓麻,梓茉
あせい	愛星,亞星
あつ	亜津,亜都,愛都
あつき	あつき,愛槻,葵月,茜月,渥喜,安月,温月,温樹,貴紀,京稀,厚嬉,厚妃,紅月,彩月,彩月季,春希,淳季,淳記,淳木,篤姫,敦妃
あづき	あづ妃,亜月,亜月紀,娃月,愛月,愛月姫,逢月,葵月,絢月,綾月,安月,安都姫,杏亜葵,杏月,海月,京季,空月,彩月,彩都希,采月,朱月,相月,暖月,篤月,碧月,麻月,有槻,藍月,和月
あまね	あまね,あま音,亜音,亜真音,亜真寧,亜真嶺,亜舞音,亜舞寧,亜舞嶺,亜麻音,亜麻寧,亜麻嶺,亜茉音,亜茉寧,亜茉嶺,阿愛寧,阿万音,愛音,愛子,愛真音,愛真祢,愛真寧,愛真嶺,愛星,愛天音,愛寧,愛舞音,愛舞寧,愛舞嶺,愛麻音,愛麻寧,愛麻嶺,愛茉音,愛茉寧,愛茉嶺,葵弥,安真寧,安真嶺,安舞音,安舞寧,安舞嶺,安麻音,安麻寧,安麻嶺,安万音,安茉音,安茉寧,安茉嶺,杏真音,杏真寧,杏真嶺,杏舞音,杏舞寧,杏舞嶺,杏麻音,杏麻寧,杏麻嶺,杏弥,雨子,雨称,雨心,雨嶺,海真音,海寧,甘音,甘寧,甘弥,昂真寝,彩真音,彩真寧,彩舞音,彩麻音,彩茉音,彩茉祢,彩茉寧,采真音,舜,心愛姫,羨音,天,天々音,天願,天希,天響,天子,天女,天声,天舞音,天峯,天望,天麻音,天稔,天礼,遍,遍音,明弥,明茉音,明茉寧,弥音,弥寧,弥峯,弥嶺,有寧,有舞音,余音,零音,和真音,和麻寧,和茉音,和茉寧,彌
あむ	亜紫,愛結,愛月,愛紫,愛望,愛睦,愛矛,愛眸,逢心,葵結,葵舞,安夢,杏睦,杏夢,海霧,空舞,空夢,彩結,彩舞,彩夢,桜夢,朱結,天月,天舞,天夢,編夢,歩,歩夢,麻夢,有夢,亞夢,曖夢
あむろ	亜蕪路
あもん	愛文,雅門,天羽
あや	あや,アヤ,亜邪,亜谷,亜也,亜冶,亜夜,亜耶,亜弥,亜矢,亜已,亜彌,娃文,娃夜,娃耶,娃弥,阿也,阿弥,阿矢,愛,愛綾,愛哉,愛彩,愛也,愛耶,愛弥,愛矢,愛彌,愛椰,逢弥,絢,絢夜,絢弥,絢矢,綾,綾弥,綾玲,安耶,安野,安矢,杏耶,郁,英,花,技,空絢,空彩,空文,空弥,恵,言,吾彩,吾耶,吾弥,吾矢,彩,彩息,彩命,彩也,彩夜,彩耶,彩弥,彩矢,彩優,彩陽,彩椰,彩綺,采,史,紗,朱,純,順,彰,章,随,操,早彩,藻,虹美,斐,彪,文,歩弥,歩陽,麻,麻弥,麻椰,明耶,明弥,明矢,明優,明椰,紋,紋也,有耶,有弥,遥,理,礼,亞也,惠,皓雅,禮,綺,綺矢,繡
あやお	絢愛,絢音,絢桜,絢緒,綾愛,綾央,綾桜,綾緒,綾織,彩愛,彩央,彩音,彩桜,彩緒,采緒,紗緒,朱央,純緒,彰緒,斐緒,理緒,礼生,綺愛,綺音,綺桜
あやき	亜也輝,亜弥希,愛姫,絢貴,絢公,絢生,絢妃,絢姫,綾葵,綾季,綾紀,綾貴,綾姫,郁葵,郁伎,郁喜,郁希,郁祈,郁季,郁稀,郁紀,郁姫,郁来,郁綺,漢城,彩葵,彩稀,彩月,彩生,彩妃,彩姫,彩来,采希,采季,采樹,朱季,朱紀,文希,文規,文妃,文姫,麻綾樹,礼姫,綺姫
あやと	彩桃,史都
あゆ	步,あゆ,亜結,亜夢,亜佑,亜優,亜友,亜宥,亜悠,亜憂,亜有,亜柚,亜由,亜祐,亜裕,亜遊,亜夕,亜揺,亜侑,娃結,娃友,娃憂,娃有,娃柚,娃祐,娃裕,娃侑,娃喩,娃釉,阿宥,阿由,愛,愛弓,愛結,愛夢,愛諭,愛唯,愛優,愛友,愛宥,愛悠,愛有,愛柚,愛由,愛祐,愛裕,愛夕,愛侑,逢結,葵結,葵夢,葵諭,葵由,絢宙,絢百,絢夢,絢佑,絢優,絢友,絢悠,絢夕,綾結,綾夢,綾優,鮎,安結,安夢,安佑,安宥,安悠,安由,安祐,安侑,安釉,杏,杏夢,杏佑,杏優,杏宥,杏悠,杏柚,杏祐,杏侑,空結,空夢,空優,空宥,吾弓,吾結,吾唯,吾佑,吾優,吾友,吾宥,吾悠,吾有,吾柚,吾由,吾祐,吾裕,吾夕,吾侑,彩弓,彩結,彩夢,彩佑,彩優,彩友,彩悠,彩有,彩柚,彩由,彩祐,彩裕,采夢,采優,朱友,初姫,肖,心宙,心夢,天夢,文夕,歩,歩夢,歩優,歩友,歩柚,麻弓,麻友,麻有,繭,明結,明夢,明優,明友,明由,有結,有夢,有優,有宥,有悠,有由,有揺,藍結,藍夢,和夢,亞有,亞由,晏宥
あゆき	亜結希,亜結生,亜倖,亜佑来,亜優紀,亜友稀,亜由季,亜由紀,亜夕妃,愛結姫,愛倖,愛幸,愛雪,愛優希,愛優姫,葵雪,杏倖,杏雪,杏優季,彩倖,彩雪,彩夢来,采優姫,淡雪幸,碧夢絆,歩妃,有友己
あゆと	歩知
あゆむ	あゆむ,亜柚夢,亜夕夢,愛結,愛結夢,愛歩,愛夢,愛夕夢,綾優夢,杏歩,歩舞,歩唯夢,有夢,遥歩
あらた	あらた,天蘭
あらん	阿欄,愛桜,愛走,愛欄,愛藍,安蘭,杏蘭,紅藍,明藍,嵐蘭,和覧
あり	亜利,亜吏,亜李,亜梨,亜理,亜璃,亜里,亜凛,亜莉,阿利,阿梨,阿理,阿璃,阿里,阿莉,愛利,愛梨,愛理,愛里,愛凛,愛莉,愛凜,逢莉,葵李,安梨,安理,安凛,安凜,杏里,可,空璃,彩梨,彩理,彩里,彩凛,彩莉,彩凜,青璃,青俐,明梨,明璃,明莉,有梨,有理,有璃,有里,有莉,陽莉,晏凛,曖理
ある	亜月,亜璃,愛月,愛春,愛流,愛留,愛瑠,逢瑠,或留,杏月,杏流,杏琉,杏留,杏瑠,空月,空流,空留,空瑠,彩瑠,歩
あると	亜留兎,愛音,杏月灯,彩月灯,彩莉采
あるま	愛琉摩
あれん	愛音,愛虹音,愛漣,逢恋,絢蓮,海連,吾蓮,彩虹音,彩玲,彩恋,彩連,采蓮,星虹音,星蓮,明玲音,明恋,明漣,有蓮,陽恋,和虹音,綺蓮
あろは	亜呂覇,亜呂芭,亜朗花,阿呂巴,愛羽,愛花,愛華,愛葉,彩朗羽,采夢花,暖春,有華
あん	あん,アン,亜杏,愛杏,愛音,愛晏,安,庵,按,案,杏,杏音,朱音,晏
あんじ	愛花,愛華,愛心良,安時,安路,安兒,杏花,杏糸,杏詩,杏時,杏蒔,杏実,杏虹,杏姫,杏路,空架虹,空慈
あんり	あんり,あん莉,アンリ,亜武里,亜璃,亜里,愛凛,愛凜,安栗,安梨,安璃,安厘,安麗,安俐,安凛,安凜,庵浬,庵梨,庵理,庵璃,庵里,庵凛,庵莉,庵凜,鞍梨,杏亥,杏織,杏律,杏倫,杏怜,杏鈴,杏麗,杏凛,杏凜,温理,音綾,彩梨,彩里,明凛,晏利,晏李,晏梨,晏璃,晏麗,晏凛,晏莉
いあん	愛杏,以杏,伊安,伊杏,偉杏,惟杏,維杏,衣杏,彩杏,唯安,唯杏,良杏,苺杏
いお	イオ,伊於,伊欧,伊桜,伊保,依音,依桜,依緒,依青,依麻,依和,夷緒,惟愛,惟維,惟凰,意央,維愛,維乙,維緒,維穂,衣愛,衣絃,衣桜,一緒,五央,五百,好音,彩央,糸央,緒,生桜,生織,泉音,泉緒,泉穂,猪尾,斐音,美和,癒音,唯愛,唯音,唯零,李音,李緒,良緒,苺愛,苺央
いおり	いおり,愛彩,愛織,庵梨,庵莉,以奥理,以和里,伊於里,伊央莉,伊王利,伊桜里,伊桜莉,伊緒里,伊緒莉,伊小里,伊捺離,伊栞,依央李,依央梨,依央莉,依央凜,依音梨,依桜里,依緒利,依緒梨,依緒里,依緒莉,依織里,依織凜,依穂里,夷緒理,夷織,委織,惟央梨,惟央理,惟音璃,惟緒梨,惟緒里,惟緒莉,維愛理,維央莉,維緒莉,衣央李,衣央梨,衣央理,衣央里,衣央莉,衣音梨,衣桜梨,衣桜里,衣緒梨,衣緒里,衣緒莉,衣織梨,衣織理,衣織里,衣生吏,衣折,衣栞,井和理,育音理,一緒利,一緒里,一緒俐,一織莉,一生莉,一懍,音織,幾織,季音梨,今生里,彩央莉,彩桜李,彩桜莉,彩百利,彩里,采織,桜梨,祝織,緒梨,緒理,緒里,緒莉,色桜里,生栞,唯愛璃,唯於莉,唯央利,唯音璃,唯緒梨,唯緒里,唯緒莉,唯栞,李央莉,已桜里,洧織
いおん	以苑,伊桜,依音,偉恩,囲音,維音,緯温,衣隠,生音,泉音,碧音,癒音,唯恩,唯音,苺音,苺想
いく	いく,伊久,伊宮,伊句,伊紅,伊来,伊來,依久,委久,意空,意来,維空,衣久,衣宮,衣矩,衣空,衣公,衣紅,衣来,衣來,育朋,郁空,音空,唯玖,唯空,唯紅,唯来,唯來,良空
いくお	一久青
いこい	いこい,愛徠,伊恋,衣恋,憩依,唯心,唯恋,唯恋衣,和来
いさ	伊沙,伊咲,依沙,衣沙,衣彩,衣咲,衣紗,音彩,沙,唯咲
いさき	いさき,愛咲,伊沙希,伊沙季,伊沙紀,伊沙記,伊沙樹,伊咲綺,依沙希,依咲,依早祈,惟咲,維咲,衣咲,衣咲妃,一沙希,一沙祈,一冴祈,一咲,響咲,沙樹,泉咲,唯咲
いさな	伊佐奈,伊佐那,伊砂奈,伊紗奈,依沙奈,依沙那,依紗菜,依紗奈,衣沙菜,沙南,唯沙奈,唯紗奈,勇名,湧和,洸奈
いさみ	亜紗実,伊讃実,伊讃美,依紗美,衣咲心,衣紗実,衣紗美,勲実,清,石美,勇観,勇見,勇未,勇魅,来美
いずほ	泉歩
いずみ	いずみ,いず海,いず美,イズミ,愛純,愛澄,愛美,伊住,伊泉,依瑞美,依泉,依都美,委住,惟寿美,惟清,維泉,維豆美,衣紀,衣珠実,衣寿実,衣泉,井澄,郁澄,一寿美,壱純,五実,五澄,彩純,彩澄,出珠美,出水,潤美,水泉,澄,清泉,生純,生泉,聖泉,泉光,泉純,泉心,泉深,泉南,泉美,泉未,泉岬,泉弥,寧美,碧泉,穂美,唯珠実,唯澄,稜海,稜美,和,和澄,已澄
いちと	唯智翔
いつか	いつ花,愛佳,愛花,愛華,愛香,愛都花,伊都花,伊都香,依津圭,依杷,惟杷,衣束,衣杷,一珂,一花,一香,一翔,逸加,逸可,逸嘉,逸夏,逸果,逸歌,逸花,逸華,逸賀,逸香,乙夏,乙花,乙華,敬佳,敬夏,敬花,敬香,五花,五華,五香,伍香,慈香,出翔,泉月花,姫月香,唯都夏,稜佳
いつき	いつき,愛希,愛月,伊都希,伊都稀,衣津伎,衣槻,衣都希,一汐,一妃,一姫,壱暉,溢希,溢祈,逸己,逸妃,逸木,乙嬉,乙月,乙生,音月,希樹,五稀,五妃,彩月,斎葵,慈季,樹稀,生葵,斉希,千生,猪月,癒月,稜妃,良月
いつは	いつ葉,依都葉,衣月羽,衣津波,衣都羽,一波,壱羽,敬華,敬葉,五春,五芭,唯津葉,稜芭,稜葉
いつほ	一朋,逸誇,逸歩,逸朋,敬穂,稜朋
いづる	いづる,依鶴,維絃,衣弦,衣鶴,出,斐鶴
いのり	いの莉,以愛,以乃莉,伊紀,伊乃李,伊乃里,伊乃莉,伊法,依憲,依実,依乃里,依乃莉,依里,依礼,偉乃里,惟乃莉,衣紀,衣乃利,衣乃李,衣乃里,衣乃莉,一愛,一乃理,一乃里,祈祝,祈織,祈乃莉,祈吏,祈理,祈璃,祈里,祈鈴,祈莉,十字架,祷莉,冶乃里,唯祈,唯乃莉,李紀,李乃鈴,苺乃璃
いぶ	愛舞,伊歩,依舞,依歩,依夢,維舞,衣聖,衣舞,衣歩,一舞,祈風,色歩,生葵,生富,生舞,聖雪,聖夜,唯聖,唯舞,唯風,唯歩,良舞
いぶき	いぶき,イブキ,愛夢希,愛綺,伊雪,伊舞妃,依芙祈,依芙季,依芙紀,依風希,依歩季,惟生,惟舞希,惟蕗,維風紀,衣舞祈,衣舞紀,衣舞姫,衣舞綺,衣楓,衣蕗,衣歩希,郁舞妃,一舞,音露,芽,芽希,芽季,芽寿,雅姫,気吹,祈蕗,彩蕗,初季,初姫,生舞輝,聖姫,泉美萌,泉舞希,冬姫,歩季,歩紀,歩生,歩姫,夢姫,唯生希,唯楓,唯蕗,唯歩希,唯歩姫,李蕗,絆妃,苺生希
うきょう	右喬,宇慶,兎鏡,佑経,優杏,有叶
うさ	うさ,愛倖,愛紗,宇佐,宇沙,宇咲,宇紗,羽沙,羽咲,羽紗,卯沙,卯咲,卯紗,生紗,優咲,憂蓑,侑佐,侑沙
うしお	有詩央
うた	うた,愛樹,愛多,愛夢,宇樹,宇妥,羽音,羽楽,羽妥,羽樂,卯楽,卯多,唄歌,唄多,詠多,欧,音葵,音楽,音咲,歌楽,歌詩,歌宝,歌来,雅樂,海詩,楽,楽音,嬉唄,嬉詠,嬉歌,嬉楽,嬉詩,嬉唱,嬉多,嬉汰,嬉陽,吟多,胡樂,詞歌,詩歌,詩花,詩楽,詩心,詩多,詩泰,初歌,唱,唱朋,奏,奏音,美唄,美楽,美詩,美多,譜,優葵,優音,優楽,優詩,優多,優泰,優妙,憂多,謡,和歌,咏,謌,謠,謳
うみ	うみ,ウミ,愛海,愛珠,愛深,愛美,愛望,愛澪,宇見,宇実,宇珠,宇充,宇美,宇訪,宇望,宇未,羽見,羽実,羽心,羽深,羽水,羽聖,羽南,羽美,羽訪,羽望,羽未,羽魅,羽弥,雨愛,雨海,雨深,雨美,雨未,雨眠,卯海,卯実,卯美,卯訪,卯未,卯巳,卯弥,唄海,歌美,海愛,海実,海珠,海充,海心,海水,海美,海碧,海未,海箕,海弥,結海,湖,湖水,湖美,胡見,胡実,胡美,胡魅,詩愛,詩海,詩実,樹花,潤海,初海,初心,初美,星湖,生,生実,兎美,梅美,美海,美光,美心,美星,佑実,優愛,優光,優実,優珠,優心,優深,優美,優満,優未,憂愛,憂美,憂望,憂未,有海,有見,有笑,有深,有美,有望,有未,有澪,侑実,侑心,侑美,侑未,翔心
うみお	羽美央,羽美音,羽美緒,羽美生,卯海緒,海音,海緒
うるは	うる羽,愛流羽,愛瑠羽,愛瑠巴,羽月葉,羽流華,羽琉葉,潤栄,潤生,潤琶,潤葉,美羽,美心華,美晴,美巴,美波,美葉,優瑠波,麗花,麗華,麗春,麗心,麗巴,麗波,麗葉
えい	依惟,衣惟,映維,栄依,永依,瑛惟,瑛已,英依,英唯,絵惟,絵衣,恵依,恵惟,恵衣,恵唯,秀,笑維,笑衣
えいき	映季,映姫,栄貴,栄姫,永姫,英姫
えいち	笑一
えいと	笑一都
えいる	エイル,愛瑠,叡瑠,営瑠,映瑠,栄瑠,永月,永瑠,瑛月,瑛瑠,英月,英流,英留,衛瑠,絵依瑠,絵衣留,絵衣瑠,絵入,恵衣瑠,江衣瑠,笑衣琉,笑瑠,衞瑠
おうた	桜唄,桜歌
おうま	央磨
おうら	央來,皇良,桜愛,桜羽麗,桜楽,桜咲,桜来,桜麗,桜徠,緒星,邑楽,櫻蘭
おと	愛乙,愛音,愛采,愛翔,於冨,央永,央音,央十,央橙,旺都,乙采,乙十,乙都,乙冨,音愛,音空,音心,音澄,音想,音兎,音堵,音杜,音途,音把,音百,及都,響音,吟,桜,桜乙,桜叶,桜采,桜士,桜時,桜仁,桜兎,桜斗,桜杜,桜冬,桜桃,桜美,桜百,竣采,緒都,緒音,緒采,緒十,緒途,緒豊,緒橙,小采,織都,織音,織采,織翔,臣都,奏音,捺采,百都,穂音,麻音,麻都,躍,陽百,櫻都
かい	郁異,伽衣,佳位,佳居,可衣,嘉位,夏郁,家伊,果依,果惟,歌依,歌惟,珂位,珂冶,禾惟,花伊,花惟,花維,花郁,華惟,華一,霞惟,海衣,香惟,香維,香似,和依,翔維
かいあ	花良明,快愛,懐空,海愛,皆愛,絵亜,絵愛,香衣明
かいと	郁糸,加愛,神愛
かいほ	海歩,海朋
かいや	海夜,絵夜
かいら	佳伊良,海楽,海藍,海蘭,絵良,香平,青楽,桧来,櫂蘭,櫂良
かいり	かいり,嘉唯里,夏依莉,果衣莉,架衣梨,珂維李,花生梨,華依,華彩莉,介里,快琳,絵莉,貝吏,浬桜,香衣璃,香衣莉,桧梨,桧麗,桧莉,楷里,翔梨
かえ	かえ,伽絵,伽江,佳愛,佳依,佳衣,佳叡,佳映,佳栄,佳永,佳瑛,佳英,佳詠,佳絵,佳恵,佳江,佳咲,佳枝,佳重,佳笑,佳媛,佳惠,加依,加衣,加映,加瑛,加英,加絵,加恵,加江,加枝,加笑,可愛,可依,可衣,可映,可瑛,可英,可絵,可恵,可江,可枝,可笑,嘉依,嘉衣,嘉映,嘉永,嘉詠,嘉恩,嘉恵,嘉慧,嘉笑,夏愛,夏依,夏衣,夏栄,夏永,夏瑛,夏英,夏絵,夏恵,夏江,夏枝,夏笑,家愛,果依,果衣,果映,果永,果瑛,果英,果詠,果絵,果恵,果咲,果枝,果笑,架衣,架瑛,架笑,歌衣,歌瑛,歌英,歌詠,歌絵,歌恵,歌江,歌咲,歌枝,歌笑,河映,河英,珂依,珂瑛,禾依,禾衣,禾瑛,禾英,禾絵,禾恵,禾慧,禾枝,禾笑,花愛,花依,花衣,花映,花瑛,花英,花詠,花悦,花榎,花会,花絵,花恵,花江,花咲,花枝,花重,花笑,花媛,花柄,華依,華衣,華映,華永,華瑛,華英,華詠,華絵,華恵,華慧,華江,華咲,華枝,華笑,華媛,華榮,菓江,嘩愛,嘩笑,迦恵,霞江,賀栄,賀詠,賀絵,海依,海衣,海絵,海咲,叶永,叶詠,叶笑,椛衣,椛笑,樺恵,袈永,圭依,圭絵,圭恵,圭慧,圭江,圭笑,圭惠,桂絵,香愛,香依,香衣,香映,香栄,香永,香瑛,香英,香詠,香会,香絵,香恵,香慧,香江,香咲,香枝,香笑,奏永,奏咲,日詠,日咲,楓,楓依,楓衣,楓詠,耶咲,和依,和衣,和咲,和笑,翔恵
かえで	かえで,カエデ,愛瑛天,佳衣輝,佳絵汀,加江出,夏枝花,果楓,架楓,歌楓,花楓,花柄弟,華愛楓,華楓,椛,圭楓,香恵輝,香楓,秋楓,奏恵天,奏楓,楓夏,楓花,楓華,楓季,楓汀,楓美,楓姫,楓葉,栞枝
かお	薰,かお,伽愛,伽尾,佳愛,佳於,佳央,佳音,佳桜,佳緒,佳織,佳生,佳想,加愛,加桜,加尾,可愛,可央,可緒,嘉愛,嘉緒,夏愛,夏央,夏広,夏緒,夏生,夏和,果愛,果央,果乙,果音,果桜,果緒,果生,果和,架愛,架麻,架陽,歌愛,歌音,歌桜,歌和,歌凰,珂愛,珂緒,禾愛,禾乙,禾音,禾緒,花緖,花愛,花央,花欧,花王,花乙,花音,花桜,花緒,花生,花尾,花百,花鳳,花和,花凰,花櫻,茄央,華愛,華於,華央,華旺,華音,華桜,華緒,華生,華鳳,華和,華櫻,嘩音,賀愛,馨愛,叶緒,叶織,叶百,椛桜,椛生,薫,圭央,香,香緖,香愛,香央,香音,香桜,香緒,香織,香和,陽櫻,珈桜,珈櫻
かおる	薰,佳緒,佳麻流,夏愛,架於留,花,花桜琉,花緒蕗,花青留,華往路,華織,馨子,叶織,薫琉,圭央瑠,圭織,香愛瑠,香奥留,香欧瑠,香薫,香緒瑠,香緒鈴,香流,香留,香瑠,神王琉,黛,董,匂,楓純,恋香
かおん	佳音,加恩,可恩,嘉恩,嘉音,夏苑,夏遠,夏音,果穏,果音,架音,歌音,花隠,花苑,花恩,花穏,花音,華穏,華音,叶音,樺音,薫音,香恩,奏音,鶴恩,楓音,和苑
かがり	夏河利,歌々莉,花々莉,花芽李,花許,花香里,華芽莉,華賀梨,輝梨,輝理,輝璃,輝莉,香々莉,香芽里,香賀利,香賀梨,香賀理,香賀里,香賀莉,香里,耀,燎里,燎莉
かぐら	加桜,夏楽,夏空楽,果楽,歌楽,歌蔵,花楽,花紅良,華楽,華弓姫,華昏,華暖,楽羅,月愛,香桜,神樂
かける	かける,花架琉
かすが	夏清,花清,華清,香清,春賀,蘭清
かず	胤,伽珠,佳珠,佳須,佳津,加珠,加須,嘉珠,嘉寿,夏珠,果珠,歌珠,花珠,花寿,花須,花瑞,花津,香寿,香須,香津,寿
かずい	花瑞,数衣,万衣
かずき	かず輝,一妃,一姫,円喜,佳珠葵,佳寿希,歌月,花月,香月,寿季,倭嬉,和妃,和木
かずさ	かずさ,一嵯,一砂,一彩,一咋,一朔,一桜,一朝,一櫻,円咲,佳沙,佳朱咲,加朱紗,加寸紗,架咲,華寿咲,司紗,寿嵯,寿沙,寿彩,寿咲,寿紗,春沙,千嵯,千彩,千咲,千桜,千紗,知紗,冬彩,冬紗,万沙,麗咲,倭沙,和嵯,和瑳,和彩,和朔,和桜,和妙
かずね	一嶺,員音,胤嶺,華瑞祢,計音,計寧,計嶺,香寿音,春音,数音,暦音
かずは	かずは,かず葉,一羽,一映,一花,一華,一巴,一覇,一波,壱羽,壱覇,員羽,員葉,円葉,佳珠羽,佳珠葉,佳寿華,佳寿葉,佳津葉,加珠葉,夏鶴華,果珠羽,華珠羽,華珠葉,華寿巴,華寿葉,紀葉,計羽,計葉,香寿葉,寿羽,寿華,寿葉,数羽,数葉,千華,千覇,千葉,冬桜,冬葉,万花,万巴,良葉,麗華,和映,和果,和花,和華,和寿華,和春,和晴,和生,和津葉,和巴,和杷,和翔
かずほ	一畝,一星,加寿穂,寿歩,数穂,千歩,多穂,和步,和捗,和津穂,和保
かずま	千愛
かずみ	かずみ,かず美,一澄,一魅,佳珠実,佳寿実,佳寿美,佳住,佳瑞美,加図海,可純,花珠実,花寿実,花住,花純,花瑞美,花津実,華寿美,華純,霞,霞実,香朱実,香珠実,香珠美,香寿実,香寿美,香充実,香瑞実,香津実,香壽実,千美,万実,麗心,和,和珠,和純,和満,和魅,和弥
かずよ	かず世,一世,一代,一夜,員代,加寿代,圭寿代,圭代,計世,計代,計夜,香津代,算代,師世,数代,多代,万代,量代,和詠,和世,和代,和夜,和余,和誉
かつき	加椿希,可月季,夏月,歌月,霞月,樺月,香津季,克妃,神月
かつみ	花津美,花通美,花摘,花都美,華積,華摘,香月美,香津美,香摘,克見,克未,勝観,勝見,勝未,勝魅,優弥
かつら	桂良,香桂,香都羅,藤
かづき	かづき,かづ希,伽月,佳津伎,歌月,華槻,霞月,雅月,椛月,薫月,香通紀,勝喜,勝希,勝季,勝紀,勝記,勝貴,勝輝,勝樹,勝生,勝木,麗月
かな	かな,カナ,愛,郁菜,郁奈,郁那,榎夏,榎菜,榎渚,榎奈,榎那,榎凪,榎南,伽夏,伽菜,伽渚,伽奈,伽那,伽凪,伽捺,伽南,伽名,伽梛,佳夏,佳華,佳菜,佳声,佳奈,佳那,佳南,佳楠,佳姫,佳舞,佳名,佳鳴,佳来,佳和,佳梛,加夏,加菜,加奈,加那,加南,加楠,加梛,可菜,可奈,可那,可南,可名,嘉菜,嘉多,嘉奈,嘉那,嘉捺,嘉南,嘉名,夏花,夏采,夏菜,夏七,夏渚,夏声,夏奈,夏那,夏凪,夏南,夏楠,夏納,夏波,夏名,夏来,夏梛,科南,果夏,果菜,果七,果奈,果那,果南,果楠,果名,架夏,架菜,架渚,架奈,架那,架凪,架南,架納,架名,歌菜,歌奈,歌那,歌南,歌名,歌和,珂夏,珂菜,珂奈,珂那,珂凪,珂南,珂名,珂梛,禾夏,禾菜,禾渚,禾奈,禾那,禾凪,禾南,禾名,禾梛,花愛,花夏,花菜,花七,花成,花奏,花奈,花那,花凪,花南,花波,花媛,花名,花流,花和,花梛,茄茄,茄奈,茄那,華愛,華央,華夏,華菜,華雫,華奈,華那,華凪,華捺,華南,華楠,華名,華和,菓奈,菓凪,嘩夏,嘩菜,嘩奈,嘩那,嘩南,嘩名,嘩和,嘩梛,迦奈,迦那,迦捺,霞那,賀菜,賀奈,雅凪,廻夏,恢,海夏,海菜,海那,海凪,海南,馨奈,馨那,楽,叶,叶菜,叶七,叶渚,叶成,叶奏,叶奈,叶凪,叶南,叶必,椛菜,椛奈,椛南,椛梛,樺菜,樺梛,柑愛,柑菜,柑渚,柑奈,柑那,柑凪,柑南,柑名,柑梛,甘夏,輝奈,輝凪,協,金成,袈菜,圭夏,圭菜,圭奈,圭那,圭南,圭撫,圭名,香愛,香夏,香菜,香七,香奈,香那,香凪,香南,香納,香名,香梛,哉,哉中,称,神那,奏,奏愛,奏音,奏夏,奏菜,奏奈,奏那,奏凪,奏梛,泰,代梛,適,日夏,日菜,日奈,日納,楓菜,楓奈,楓凪,風夏,風奈,風名,耶那,耶凪,要,蘭樹,和華,和菜,和樹,和水,和成,和奈,栞花,栞菜,栞奈,珈夏,珈菜,珈渚,珈奈,珈那,珈凪,珈捺,珈南,珈名,珈梛,翔夏,翔菜,翔奈,翔那,翔凪,諧
かなう	愛羽,叶宇,叶生,叶奈羽,叶有,称生,奏雨,奏歌,奏侑
かなた	愛多,永遠,佳奈多,歌奈蛇,花菜汰,花那多,叶向,叶菜汰,叶妥,香菜多,香奈多,奏向
かなで	愛奏,音奏,佳奏,加奏,夏菜出,夏奈汀,花奏,華奏,華奈出,雅奏,香奏,心奏,奏天,奏那,奏楓,日奏,楓奏,夢奏
かなと	愛乙,榎夏,翔和
かなむ	果奈夢,叶菜夢,奏歩
かなめ	かなめ,愛芽,愛女,郁奈愛,伽奈愛,伽納苺,佳菜芽,佳菜女,佳奈愛,佳奈芽,佳奈女,佳那愛,佳那芽,佳那女,加夏芽,加菜愛,加七芽,加奈愛,加奈芽,加奈女,加那愛,可菜愛,可菜芽,可奈愛,可那愛,可那芽,夏南愛,夏南芽,果菜芽,果菜苺,果奈愛,架那芽,歌和明,花愛芽,花菜芽,花奈芽,花奈匁,花那梅,花名芽,花鳴芽,華菜愛,華奈愛,華那愛,華那芽,華萌,海那芽,叶愛,叶七芽,叶女,叶奈芽,叶萌,叶明,樺奈芽,紀瞳,圭芽,香菜愛,香菜芽,香奈芽,香奈梅,香那愛,哉女,神奈芽,奏愛,奏雨,奏女,奏瞳,奏萌,奏夢,要愛,翔凪芽
かなる	かなる,愛琉,愛瑠,央琉,央瑠,佳愛,佳菜留,佳奈瑠,加奈瑠,嘉愛,夏愛,果愛,歌愛,花愛,華愛,華南瑠,華玲,海愛,叶,叶愛,叶月,叶流,香愛,香匠,奏音,奏流
かむい	可夢以,花夢依
かん	柑
きいち	希伊知,木苺
きお	葵央,黄央,喜音,喜緒,希桜,希緒,希織,希凰,祈央,祈緒,季緒,季和,稀乙,稀音,稀桜,稀緒,稀生,紀緒,紀織,紀保,記生,貴桜,貴緒,軌緒,輝緒,騎桜,吉桜,妃央,妃和,姫桜,木音,来緒,來央,綺音
きおり	葵織,喜織,嬉織,希央莉,希緒里,希緒莉,季緒里,季織,紀乙里,紀織,貴織,錦織,絹織,清織,妃織,姫王琳,姫織,綺織
きずき	絆輝,絆妃
きずな	きずな,愛結,愛絆,葵珠愛,葵珠夏,葵珠菜,葵珠奈,葵珠凪,葵珠南,葵珠名,葵絆,希沙,希珠愛,希珠菜,希珠奈,希珠那,希珠凪,希珠南,希珠名,希寿奈,祈絆,季沙,季珠奈,紀砂,輝絆,結,結愛,結紘,結繫,樹沙,心愛,心繋,創奈,創南,築奈,姫沙,姫砂,姫珠愛,姫珠菜,姫珠奈,姫珠那,姫珠凪,姫珠南,姫珠名,恋叶,絆愛,絆菜,絆七,絆心,絆生,絆奈,絆那,絆納,絆名,絆繫,綺沙
きせき	葵汐,葵夕,希世記,希星,希清姫,希夕,記世希,輝星稀,輝星姫,輝星絆,妃汐,妃世希,姫汐,姫世輝
きづき	葵月,嬉月,岐月,揮月,祈月,季月,輝月,妃月,姫月,綺月
きなり	きな莉,黄菜里,希菜里,希奈梨,希奈璃,希奈里,希鳴,季音,季生,稀音,稀雅,稀生,稀生李,稀奈凜,紀奈里,貴雅,玖慈,玖生,樹奈里,生雅
きはる	黄春,喜日,岐春,祈陽,季春,稀暖,稀陽,紀遥,貴晴,玖桜,玖春,樹羽琉,樹葉琉,姫遥,木春,来春,綺華,綺晴,綺遥,綺陽
きひろ	葵紘,葵尋,葵裕,喜央,希紘,希恕,希陽呂,毅寛,気恕,祈恕,季央,季景,季紘,季恕,季宙,季祐,稀尋,紀央,紀尋,規恕,貴紘,輝恕,樹寛,生恕,妃央,妃優,姫尋,来恕,綺恕
きょう	きょう,紀葉,記葉,共,喬羽,興,敬,景,己葉,澄羽
きょうま	亨実
きよ	きよ,キヨ,葵世,葵代,喜,喜世,喜代,喜与,喜誉,嬉与,希依,希詠,希佳,希呼,希世,希代,希夜,希予,希与,希葉,祈代,季依,季佳,季世,季代,季葉,稀世,稀代,稀与,稀葉,紀世,紀代,紀予,紀葉,規予,記世,記代,貴四,貴世,貴代,吉良,祁代,己葉,清,清依,清世,聖,雪,白,妃代,妃予,妃葉,姫世,奎代,綺世
きら	きら,キラ,葵羅,葵蘭,葵良,乙良,喜羅,喜良,喜麗,嬉来,嬉來,嬉徠,希愛,希楽,希空,希咲,希桜,希星,希羅,希来,希良,希麗,祈聖,季楽,季咲,季良,稀羅,稀良,稀來,稀萊,紀羅,紀来,紀良,貴良,貴來,輝空,輝桜,輝星,輝羅,輝蘭,輝煌,吉良,桔来,芹星,光夢,光來,晃,彩楽,燦,樹羅,樹来,樹良,星空,星来,清良,雪華,妃星,妃羅,妃来,妃良,姫楽,姫月,姫星,姫羅,姫蘭,姫良,姫礼,姫徠,姫萊,来蘭,來礼,煌,煌星,絆咲,絆星,絆良,綺楽,綺桜,綺星,綺羅,綺蘭,綺良,綺麗,綺來
きらり	きらり,きら梨,葵蘭莉,葵良里,葵良莉,乙良里,夏星,喜輝,喜羅鈴,希光,希羅梨,希羅里,希羅琳,希羅莉,希来里,希蘭麗,希梨,希良梨,希良理,希良里,希良莉,希礼里,季楽理,季良梨,稀羅璃,紀良里,貴燦,貴蘭璃,貴蘭莉,貴良利,輝,輝星,輝星璃,輝天空,輝姫,輝羅離,輝来莉,輝璃,輝里,輝良理,輝良莉,輝莉,光輝,光梨,光里,光莉,咲星,燦,燦璃,燦里,樹羅梨,樹羅理,樹羅凜,樹良利,樹良梨,樹良理,樹良里,樹良莉,星,星輝,星光,星咲,星耀,星吏,星梨,星良梨,星煌,星莉,雪色,蒼輝,蒼瞳,妃織,妃星,妃良理,姫亜織,姫愛鈴,姫愛莉,姫楽璃,姫楽里,姫輝,姫星,姫羅李,姫羅梨,姫羅莉,姫来梨,姫来里,姫蘭璃,姫蘭里,姫蘭莉,姫良理,姫良里,姫良莉,姫鈴,姫來莉,耀,耀里,来羅凛,流星,惺彩,煌,煌星,煌星妃,煌李,煌梨,煌理,煌璃,煌里,煌琳,煌俐,絆希璃,絆星,絆煌,綺,綺星麗,綺羅星,綺羅利,綺羅李,綺羅璃,綺羅里,綺羅麗,綺羅莉,綺羅凜,綺来璃,綺良莉,綺莉
きらん	葵蘭,希藍,希蘭,祈蘭,紀蘭,貴蘭,輝星,輝欄,星音,妃藍,妃蘭,姫蘭,綺蘭
きり	きり,愛梨,葵梨,葵理,葵璃,葵里,葵凛,葵莉,伎璃,喜利,喜里,喜莉,嬉李,希梨,希璃,希里,希鈴,気李,祈璃,季璃,季莉,紀利,紀梨,紀理,紀璃,紀凛,記璃,記凛,貴梨,貴理,貴璃,貴里,貴莉,輝里,輝莉,亀梨,己莉,幸心,樹利,樹梨,樹理,樹莉,生莉,妃里,妃莉,姫梨,姫麗,姫莉,綺吏,綺李,綺梨,綺里,綺凛,綺莉,綺凜
きりあ	希璃愛,紀莉亜,輝李愛,己里亜,姫里愛,霧亜,綺莉亜
きりん	葵玲,葵凜,榎林,黄凛,伎凛,喜琳,基凛,奇凛,嬉林,希林,希隣,希鈴,希凛,季林,季凛,稀琳,紀凛,祁臨,樹林,樹琳,樹鈴,妃鈴,妃凛,妃凜,姫琳,姫凛,綺凛,綺凜
きるあ	希瑠亜,姫瑠亜,姫瑠愛,綺瑠亜
きわ	葵羽,葵輪,葵倭,喜羽,嬉羽,嬉環,嬉和,希羽,祈羽,祈和,季羽,季環,季朕,紀羽,紀環,紀輪,紀和,樹羽,樹環,樹輪,姫羽,姫倭,来羽,来和,絆和,綺羽,綺和
くう	クウ,雲羽,久羽,久空,玖羽,空海,空生,空豆,空美,紅宇,来佑,来優,來愛,來生,來優,徠優
くおん	九怨,句音,公苑,黒音,鳩遠,琥音
くるみ	くるみ,くる実,くる珠,くる美,くる弥,久琉海,久琉心,久琉美,久留実,久留美,久留未,久瑠海,久瑠実,久瑠水,久瑠美,久瑠未,宮留満,玖流美,玖琉美,玖琉弥,玖留実,玖留南,玖留美,玖瑠海,玖瑠実,玖瑠美,空月美,空琉美,空留美,空瑠美,栗実,栗未,繰実,薫実,薫心,薫美,胡実,胡桃実,胡未,呉留美,公留海,孔瑠海,紅桃,紅流美,紅琉未,紅留実,紅留未,紅瑠海,紅瑠実,紅瑠未,珍実,珍充,包心,包桃,未来実,来海,来光,来実,来珠,来心,来深,来泉,来瞳,来南,来美,来望,来琉海,来留実,来留美,来留未,来瑠実,来瑠美,來海,來光,來幸,來三,來実,來珠,來心,來桃,來瞳,來美,來望,來満,來未,來夢,來弥,來琉美,來琉弥,來留美,來瑠実,來瑠美,徠海,徠光,徠心,徠真,徠美,徠未,徠琉海,徠良
けい	ケイ,佳以,佳伊,佳惟,佳衣,佳郁,佳唯,家伊,花惟,花緯,花泉,花唯,華依,華惟,華維,華衣,華泉,華柄,快依,快衣,希伊,希位,希依,希衣,稀依,稀衣,京依,境衣,啓以,啓意,啓冶,圭以,圭伊,圭位,圭依,圭意,圭為,圭緯,圭井,圭永,圭慧,圭似,圭妃,圭唯,圭李,恵以,恵伊,恵依,恵偉,恵惟,恵意,恵衣,恵郁,恵圭,慶伊,慶依,慧伊,慧衣,慧似,敬以,敬偉,敬緯,敬似,敬入,景以,景伊,景依,景衣,景冬,桂以,桂伊,桂依,桂維,桂衣,桂己,桂糸,桂生,桂唯,桂已,渓衣,系伊,継生,計伊,計井,絹依,絹衣,康,椋,奎依,奎衣,彗依,彗衣,惠以,惠衣
けいき	佳喜,佳希,佳季,佳輝,佳樹,佳姫,佳綺,恵紀,恵規,恵貴,恵琴,恵姫,慶紀,慶来,慶來,慧祈,敬紀,蛍姫,惠喜
けいし	恵糸,恵詩,景詩
けいじゅ	恵珠
けいと	けいと,佳愛,花愛,花依都,花絃,花糸,花兎,華愛,華衣都,華絃,華糸,馨灯,希愛,希依音,希衣音,稀糸,京愛,京音,京采,京十,京図,京綸,鏡聖,恵伊都,恵衣都,恵糸,恵十,恵聖,恵聡,恵渡,恵冬,恵桃,恵瞳,恵敏,恵綸,慶冬,慶友,慶留,慧愛,慧采,慧十,慧津,敬兎,景愛,景叶,景絃,景十,景文,桂音,桂十,桂杜,桂朋,渓十,渓杜,渓都,渓灯,蛍愛,蛍十,蛍渡,計都,結叶,結糸
けいん	憩音
こあ	琴愛,乎愛,乎杏,己愛,湖亜,湖杏,湖空,胡杏,胡空,誇亜,誇愛,顧会,鼓愛,瑚彩,交愛,光亜,光愛,好彩,幸愛,幸有,紅愛,香杏,子愛,心阿,心愛,心逢,心葵,心絢,心綾,心安,心杏,心歌,心海,心空,心彩,心暖,心緋,声有,虹亜,虹恵,恋愛,恋杏,來愛,來明,晄央,琥蒼
こいき	虎粋,紺粋,心粹,恋季,恋姫,恋粹
こう	こう,虚空,琴虹,胡宇,誇羽,誇海,瑚愛,瑚兎,瑚侑,光皇,向日,香宇,香羽,香雨,皐羽,仔羽,仔有,小羽,岬,恋羽,恋海,恋生,琥友
こうき	杏妃,光姫,厚妃,孝妃,幸姫,紅姫,紅来,紅綺,香伎,香季,虹姫,凰姫
こうじゅ	幸珠,香樹,虹珠
こうは	幸羽,皇羽,紅端
ここ	ここ,ココ,愛絆,黄虎,琴子,空々,呼瑚,弧瑚,弧子,湖々,湖己,湖瑚,湖紅,湖子,湖心,胡々,胡湖,胡子,胡心,胡木,胡恋,胡琥,虎乎,虎冴,鼓々,鼓子,瑚々,瑚己,瑚湖,瑚瑚,瑚幸,瑚香,瑚子,瑚心,瑚恋,瑚昊,瑚琥,光香,光虹,光來,幸々,幸呼,幸瑚,幸子,幸来,幸恋,香々,香瑚,香子,此子,咲来,雑賀,珊瑚,小瑚,小香,小虹,小恋,心,心々,心愛,心琴,心湖,心瑚,心紅,心香,心子,心虹,心寧,心美,心恋,心昊,裾々,虹,虹々,虹馨,虹心,木胡,来々,来胡,来瑚,来幸,来來,来昊,恋々,恋乎,恋故,恋虎,恋瑚,恋紅,恋子,恋心,恋來,恋昊,來々,來胡,來瑚,來紅,來仔,來子,來心,來恋,來昊,昊瑚,昊子,昊心,昊来,昊恋,昊來,琥々,琥湖,琥瑚,琥香,琥子
こころ	ここ路,ココロ,愛,愛心,黄頃,結心,呼頃,己頃,故頃,湖頃,湖心,胡々芦,胡々蕗,胡々露,胡頃,胡心,誇誇露,瑚々心,瑚々路,瑚頃,瑚心,宏々路,幸心,香紅露,彩心,志,志心,試,児頃,嘗,小々露,小衣,小古呂,小湖呂,小瑚呂,小頃,小想,心衣,心音,心花,心結,心結咲,心瑚呂,心頃,心咲,心桜,心春,心美,心舞,心蕗,心優,心琉,心恋凜,心露,心楼,真心,想,超心,虹心,美心,媛心,木々路,優,優心,来頃,恋,恋衣,恋頃,和心,來頃,昊心,煌心,琥結
こすも	こすも,宇宙花,香李,秋桜
こと	こと,コト,杏音,杏都,維采,紀,琴,琴音,琴十,琴都,言,言都,乎乙,乎音,乎采,乎都,古乙,古采,古都,己都,戸乙,湖音,湖采,湖十,湖仁,湖聡,湖斗,湖杜,湖都,袴都,袴留,胡音,胡琴,胡采,胡仁,胡斗,胡杜,胡都,胡桃,胡巴,胡翔,虎都,虎兎,誇音,鼓乙,鼓音,鼓十,鼓人,鼓杜,鼓都,鼓百,互乙,瑚都,瑚乙,瑚音,瑚琴,瑚采,瑚十,瑚仁,瑚兎,瑚斗,瑚杜,瑚登,瑚都,瑚冬,瑚灯,瑚透,瑚瞳,瑚百,瑚翔,光都,幸瞳,紅兎,香音,香杜,香渡,香都,香瞳,香橙,采,冴音,冴都,士,子采,子都,思,詞,殊,寿,寿乙,寿都,小琴,小采,小聡,小兎,小杜,小登,小都,小冬,小飛,小富,小涼,小鈴,小翔,心音,心采,心都,心冬,心橙,心翔,虹琴,虹都,木乙,木音,木聡,木都,来音,来采,来聡,来都,蘭叶,恋音,恋登,恋都,恋瞳,來音,來采,來聡,來堵,來斗,來都,壽,琥音,琥采,琥兎,琥斗,琥杜,琥渡,琥都
さかえ	栄依,栄衣,栄映,栄英,栄絵,栄恵,栄江,栄枝,佐加枝,佐香恵,沙架恵,咲架恵,紗香恵,潤,祥枝
さき	さき,サキ,花咲,幸,幸嬉,幸希,幸祈,幸紀,幸生,幸来,佐葵,佐伎,佐喜,佐嬉,佐岐,佐希,佐揮子,佐祈,佐季,佐稀,佐紀,佐記,佐貴,佐樹,佐生,佐妃,佐木,佐李,佐來,叉希,叉紀,叉生,嵯希,嵯季,左伎,左喜,左希,左季,左紀,差季,沙葵,沙衣,沙伎,沙喜,沙嬉,沙希,沙揮,沙祈,沙季,沙稀,沙稀花,沙紀,沙規,沙記,沙貴,沙起,沙輝,沙己,沙幸,沙樹,沙生,沙妃,沙姫,沙媛,沙来,沙倭,沙來,沙綺,瑳伎,瑳希,瑳祈,瑳季,瑳稀,瑳紀,瑳規,瑳記,瑳樹,瑳木,砂葵,砂伎,砂喜,砂希,砂祈,砂季,砂稀,砂輝,砂樹,砂生,砂来,砂綺,裟伎,裟喜,裟季,裟稀,裟紀,裟規,裟貴,裟姫,彩葵,彩伎,彩喜,彩嬉,彩希,彩祈,彩季,彩稀,彩紀,彩貴,彩輝,彩芸,彩幸,彩樹,彩生,彩妃,彩姫,彩木,彩来,彩來,彩暉,彩絆,彩綺,才嬉,才媛,菜希,冴葵,冴衣,冴伎,冴喜,冴嬉,冴希,冴祈,冴季,冴稀,冴紀,冴記,冴貴,冴起,冴輝,冴己,冴樹,冴生,冴姫,冴来,冴來,冴絆,冴綺,咲,咲葵,咲衣,咲伎,咲喜,咲基,咲嬉,咲岐,咲希,咲機,咲祈,咲季,咲稀,咲紀,咲記,咲貴,咲起,咲輝,咲桔,咲芸,咲月,咲幸,咲枝,咲樹,咲秋,咲星,咲生,咲槻,咲妃,咲姫,咲媛,咲来,咲來,咲絆,咲綺,咲熙,崎,埼,作生,朔希,朔祈,桜葵,桜希,桜祈,桜季,桜紀,桜記,桜輝,桜咲,桜樹,桜生,桜妃,桜姫,桜媛,桜来,桜絆,桜綺,皐妃,皐綺,紫,紗葵,紗衣,紗伎,紗喜,紗嬉,紗岐,紗希,紗揮,紗祈,紗季,紗稀,紗紀,紗規,紗貴,紗輝,紗玖,紗己,紗幸,紗枝,紗樹,紗生,紗槻,紗妃,紗姫,紗媛,紗萌,紗来,紗來,紗暉,紗絆,紗綺,小葵,小伎,小喜,小嬉,小希,小季,小稀,小紀,小記,小貴,小輝,小樹,小生,小姫,小木,抄紀,祥,清祈,先,閃,爽葵,爽輝,爽生,早,早葵,早衣,早伎,早喜,早嬉,早希,早季,早稀,早紀,早規,早記,早貴,早輝,早幸,早咲,早樹,早生,早妃,早姫,早来,早氣,早綺,茶季,茶紀,朝葵,朝希,岬,妙祈,妙季,妙紀,妙樹,勇希,理希,理季,理紀,理生,理妃,櫻木,颯希,颯季,颯妃,颯姫,颯来
さと	さと,サト,覚,郷,郷寧,暁,恵,慧,佐音,佐登,佐都,沙音,沙采,沙斗,沙渡,沙登,沙都,沙冬,沙桃,沙瞳,沙橙,瑳音,瑳都,砂音,砂登,砂都,彩音,彩仁,彩都,彩百,冴音,咲都,咲音,咲采,咲十,咲堵,咲登,咲都,桜都,桜桃,紗音,紗杜,紗登,紗都,紗冬,紗桃,紗百,紗友,小渡,小登,小都,早音,早渡,早登,早都,知,智,都,理,里,里都,伶,怜,惺
さな	さな,さ菜,サナ,空奈,結愛,幸奈,幸那,幸梛,佐己,佐菜,佐奈,佐那,佐凪,佐南,佐名,佐和,佐梛,叉菜,叉奈,叉那,叉南,嵯菜,左菜,左奈,左那,左凪,左南,差奈,差南,沙な,沙愛,沙永,沙夏,沙菜,沙七,沙渚,沙称,沙成,沙仲,沙奈,沙那,沙凪,沙捺,沙南,沙納,沙波,沙苗,沙磨,沙名,沙来,沙和,沙來,沙梛,瑳,瑳夏,瑳菜,瑳渚,瑳奈,瑳那,瑳南,砂菜,砂七,砂奈,砂凪,砂南,砂名,鎖那,裟菜,裟奈,裟凪,裟南,彩愛,彩杏,彩永,彩夏,彩花,彩菜,彩七,彩渚,彩水,彩成,彩奈,彩那,彩凪,彩捺,彩南,彩波,彩名,彩来,彩和,彩梛,才奈,才凪,才南,才梛,采夏,采菜,采渚,采奈,采那,采凪,采梛,采絆,菜凪,菜波,冴夏,冴菜,冴渚,冴奈,冴那,冴凪,冴南,冴名,冴梛,咲愛,咲永,咲夏,咲花,咲菜,咲七,咲樹,咲成,咲奈,咲那,咲凪,咲捺,咲南,咲寧,咲波,咲名,咲来,咲和,咲來,咲梛,作菜,作奈,作那,作南,作名,朔奈,朔梛,桜愛,桜永,桜音,桜菜,桜七,桜奏,桜奈,桜那,桜凪,桜南,桜名,桜明,桜和,桜梛,桜絆,皐菜,皐七,皐奈,皐那,皐南,皐名,三七,三那,山菜,燦夏,珊夏,珊那,紗愛,紗永,紗夏,紗花,紗茄,紗菜,紗作,紗七,紗渚,紗成,紗生,紗仲,紗奈,紗那,紗凪,紗捺,紗南,紗納,紗波,紗苗,紗名,紗梨,紗和,紗梛,渚那,小夏,小菜,小七,小奈,小那,小南,小名,心那,真,真心,真奈,聖菜,然凪,爽夏,爽花,爽菜,爽七,爽奈,爽凪,早菜,早七,早女,早成,早奈,早那,早凪,早南,早波,早苗,早名,早勿,早梛,相菜,総奈,聡菜,聡奈,聡那,茶菜,茶奈,茶南,茶名,朝菜,朝奈,椿七,勇菜,勇奈,理菜,理奈,理那,理名,冷菜,櫻愛
さんご	さんご,三護,燦胡,燦瑚,燦來,晴瑚
しい	しい,梓衣,梓生,海,海依,海生,史伊,史依,史維,史衣,師維,志伊,志依,志維,志衣,志糸,志生,思依,思維,枝依,紫依,紫惟,紫衣,紫唯,詩,詩以,詩伊,詩依,詩惟,詩維,詩衣,詩生,詩唯,偲衣,織衣,椎,栞衣,栞唯
しいな	しいな,しい奈,シイナ,梓衣菜,梓衣奈,梓衣那,海七,海奈,海那,海波,柿衣菜,史衣奈,史生奈,史唯奈,志依菜,志依那,志惟菜,志衣菜,志衣奈,志稲,志李奈,獅那,紫以奈,紫依菜,紫依奈,紫衣菜,紫衣奈,紫衣那,紫衣來,紫一菜,紫奈,紫唯奈,詞衣菜,詞良菜,詩愛,詩伊奈,詩依菜,詩依奈,詩衣菜,詩衣七,詩衣奈,詩衣那,詩衣名,詩衣絆,詩月,詩菜,詩奈,詩那,詩唯菜,詩唯那,誌衣那,慈稲,慈唯菜,汐衣奈,椎愛,椎夏,椎己,椎菜,椎七,椎渚,椎奈,椎凪,椎楠,椎乃,椎梛
しお	しお,梓愛,梓央,梓桜,梓緒,史桜,史緒,子生,志愛,志音,志桜,志織,志生,思央,思緒,思和,枝緒,獅央,糸桜,糸生,紫乙,紫音,紫桜,紫緒,紫生,紫和,至桜,詞央,詩緒,詩織,詩生,滋央,自音,識央,知想,潮,潮吹,栞,栞桜
しおん	梓遠,梓乃,梓媛,沙音,咲穏,咲音,史園,始恩,思音,施恩,糸温,糸穏,紙音,紫響,紫桜,紫臣,紫媛,詩円,詩園,詩薗,詩生,詩媛,詩鳳,詩夢,詩凰,慈円,慈苑,蒔穏,蒔音,偲溫,偲音,秋音,織園,心響,心桜,心思,深苑,真温,芯音,星恩,星桜,星媛,想桜,砥音,白音,姫恩,姫音,姫媛,巳恩,栞穏,栞凪
しき	梓希,梓季,梓稀,梓妃,祇葵,祇季,史葵,史記,史姫,四葵,士稀,市木,師季,志嬉,志岐,志妃,志徠,思祈,思季,思来,支紀,糸祈,糸記,糸妃,糸姫,糸来,紫祈,紫祈,紫妃,紫姫,詞葵,詞乙,詞喜,詞希,詞季,詞綺,詩玖,詩己,詩姫,誌季,慈祈,滋季,蒔季,汐季,識器,識機,識季,識記,識騎,識樹,識聞,識来,偲葵,偲喜,偲希,偲紀,偲貴,織希,織季,色季,心稀,崇稀,崇騎,白季,白姫,白來,累,栞季,栞稀
しず	しず,梓珠,穏,玄,史珠,史寿,史須,史津,士珠,志珠,志寿,志須,志津,思杜,紫珠,紫寿,紫須,紫鶴,紫都,詩珠,詩寿,詩須,詩津,誌寿,資珠,慈珠,淑,静,寧,倭
しずき	しずき,閑稀,閑姫,志月,紫月,紫珠姫,紫津姫,雫希,雫祈,雫月,雫綺,静希,静季,静咲,静生,静姫,寧葵,寧季,寧輝,寧月,寧己,寧來,寧綺,倭葵,惺葵,惺稀,惺紀,惺己,惺生,惺来,惺來,惺煌
しずく	しず玖,梓珠玖,梓寿句,穏句,穏玖,穏月,穏紅,穏来,穏來,史珠,志雫,志珠久,思願紅,思雫,糸豆口,糸豆工,糸豆紅,糸豆来,糸豆來,紫月,紫透,詩空,詩月,詩好,詩雫,詩珠久,詩珠玖,詩珠空,詩珠来,詩珠來,詩寿紅,誌寿久,慈雫,雫花,雫句,雫玖,雫月,雫紅,雫星,雫石,雫来,雫來,真珠,芯雫,静久,静宮,静弓,静玖,静紅,静来,静來,鎮紅,滴久,滴玖,滴紅,滴来,滴來,寧久,寧玖,寧空,寧月,寧紅,寧徠,白雫,靖穹,倭久,倭玖,惺玖,惺空,惺來,惺徠,晏玖,栞雫,澪,靜空
しずる	閑流,閑留,閑瑠,紫珠流,詩須流,詩須留,静留,静瑠,静路,惺瑠,靜流
しづ	しづ,シヅ,梓津,史津,志づ,志津,志都,紫都,詩鶴,詩都,偲津,偲都
しづき	シヅ姫,海月,四月,志調,志津稀,偲月,柴月,心月,星月,静月,惺月
しの	しの,梓音,梓禾,梓希,梓乃,伎乃,祇乃,幸風,仕乃,司乃,史音,史乃,史之,史埜,史望,史野,士乃,始乃,始之,子乃,志吞,志乃,志之,志埜,志濃,志野,志輿,思乃,思望,支乃,枝乃,獅乃,祉乃,祉之,糸乃,紙乃,紫暢,紫乃,紫之,紫埜,紫濃,紫布,紫野,至乃,詞乃,詞野,詩暢,詩乃,詩之,詩埜,詩野,誌乃,資乃,慈乃,慈野,璽乃,蒔乃,蒔埜,汐乃,汐野,識乃,篠,篠乃,偲,偲音,偲乃,柴乃,織乃,織埜,信,信乃,信野,心和,染乃,椎乃,忍,白乃,美乃,柊乃,姫乃,慕,要,凌,陵,栞乃
しのぶ	シノブ,梓允,梓暢,梓乃舞,史乃舞,史乃歩,史庸,志のぶ,志喜,志更,志乃ぶ,志乃撫,志靖,思暢,枝信,紫延,紫乃布,紫乃舞,紫乃歩,紫靖,詩暢,詩乃舞,詩靖,詩遥,賜暢,慈喜,慈伸,篠歩,篠房,偲舞,偲風,信布,崇信,忍暢,忍舞,凌布
しゅら	しゅら,朱愛,朱楽,朱煌,珠藍,珠蘭,珠礼,珠來
しゅり	主李,守李,守璃,守里,守稟,朱織,朱吏,朱梨,朱律,朱劉,朱厘,朱琳,朱鈴,朱麗,朱稟,朱凜,珠織,珠璃,珠里,珠鈴,珠麗,珠莉,珠凜,種里,腫莉,趣李,趣梨,趣理,趣里,趣莉,樹里,樹莉,周梨,秋凛,秋凜,衆璃,祝璃,春璃,春麗,鋳麗,萩俐,柊梨,柊凛,柊稟,柊莉,壽凛,洵里,凜
しゅんり	春璃,春莉,准里,旬里
じゅきあ	樹紀亜
じゅの	じゅの,自由乃,朱音,珠暢,珠乃,珠望,寿希,寿乃,寿望,樹音,樹希,樹乃,准乃,淳乃,純乃,壽乃
じゅのん	珠音,珠暖,寿音,寿乃,樹音,樹乃,純音,雛暖,壽音
じゅら	じゅら,朱蘭,珠愛,珠来,珠蘭,珠來,寿楽,寿来,寿來,樹空,樹蘭,樹來,潤楽,壽良
じゅらん	珠蘭,寿蘭
すい	空以,空依,空維,空衣,空一,空似,空生,空泉,空斐,空唯,結衣,結生,沙依,朱依,朱惟,朱生,珠以,珠依,珠維,寿依,寿衣,寿射,寿生,寿泉,住衣,春依,春衣,春生,垂生,帥,推,水衣,睡,粋惟,粋衣,翠依,翠惟,翠衣,翠唯,澄依,澄衣,澄泉,澄唯,栖衣,清衣,素似,透衣,穂衣,彗依,菫唯
すかい	守海,住海,清海,菫絵
すなお	沙央,沙桜,沙緒,順央,翠真
すみ	すみ,スミ,朱未,珠海,珠実,寿海,寿見,寿実,寿珠,寿真,寿美,純,須海,須観,須見,須実,須美,須満,須未,須魅,澄,澄海,澄実,澄珠,澄美,澄未,素美,素魅,邑,遥
せいら	せいら,セイラ,彩桜,犀良,情礼,世愛,世空,世桜,世羅,世蘭,世良,世來,瀬維羅,瀬羅,瀬来,瀬良,征良,成楽,成羅,成来,成蘭,星,星ら,星愛,星衣來,星楽,星咲,星桜,星詩,星灯,星妃,星螺,星藍,星蘭,星麗,晴楽,晴空,晴咲,晴桜,晴羅,晴来,晴蘭,晴良,晴樂,栖良,正羅,清衣良,清楽,清来,清蘭,清良,清來,精羅,聖愛,聖海,聖楽,聖空,聖菜,聖咲,聖桜,聖星,聖来,聖藍,聖良,聖礼,聖麗,聖萊,誠羅,誠蘭,誠來,誓良,醒螺,青楽,青空,青来,青藍,青良,青來,静羅,静来,静蘭,静良,望来,惺愛,惺楽,惺空,惺桜,惺羅,惺来,惺蘭,惺良,惺麗,惺來,惺徠,晟来
せな	茜奏,芹菜,芹奈,芹那,芹波,攻南,犀来,施梛,汐菜,汐奈,汐那,汐南,汐楠,汐梛,紗菜,紗奈,紗苗,世愛,世夏,世奏,世捺,世納,世絆,畝菜,畝南,勢菜,勢南,成菜,成渚,成奈,星愛,星空,星砂,星菜,星桜,星捺,星楠,晴名,清菜,清七,清水,清南,清納,清波,清名,清梛,生愛,聖愛,聖薙,聖南,聖波,聖梛,誠七,青那,静那,雪菜,雪那,千愛,千菜,千奈,千捺,泉那,泉南,繊凪,敦奈,惺夏,惺菜,惺七,惺奈,惺那,惺捺,惺楠,惺絆
せら	セラ,汐咲,汐来,汐良,汐來,世愛,世咲,世麗,世來,瀬綾,瀬楽,瀬咲,瀬来,瀬來,成羅,成来,成良,成麗,星愛,星楽,星咲,星桜,星頼,星麗,星來,星樂,晴愛,晴麗,清愛,清楽,清良,清麗,清來,聖愛,聖楽,聖咲,聖羅,聖礼,聖麗,聖來,誓愛,千愛,千空,千咲,千来,千藍,千良,千麗,泉羅,泉麗,堤,晟良
せれん	せれん,セレン,世恋,世憐,瀬廉,瀬恋,瀬憐,星恋,星蓮,聖怜,聖恋,青連,雪恋
せん	川,繊,選,善
せんじゅ	千珠,扇寿
せんな	茜菜,茜雫,茜奈,茜那,仙菜,千夏,千菜,千仲,千奈,千納,扇菜,撰奈,泉菜,泉奈,鮮那
せんり	茜利,茜梨,釧璃,千梨,千倫,千琳,千怜,千凜,川梨,扇吏,扇李,扇梨,扇理,扇璃,扇莉,泉梨,泉璃,泉怜,泉鈴,泉凛,泉莉,泉凜,染里,繊琳,閃凜
そあ	空愛,空彩,空明,十愛,初亜,初彩,礎安,素亜,素阿,素愛,素安,創彩,奏杏,奏空,想亜,想愛,想彩,相亜,相阿,相愛,相安,蒼愛,湊愛,湊彩,昊愛,昊杏
そあら	ソアラ,空亜羅,空愛,空愛良,空笑,空新,空徠,楚亜良,創愛,奏愛良,奏愛麗,奏愛來,奏綾,爽亜來,想安良,想新,早彩良,蒼愛,颯愛音
そうは	奏芭,奏葉,霜波,霜芭,霜葉
そうら	創楽,奏来,爽蘭,蒼空,蒼来
そうわ	霜和
そな	そな,そ菜,空愛,空夏,空菜,空渚,空奈,空那,空凪,空南,空梛,咲奈,十菜,十奈,十那,十梛,初菜,初奈,塑菜,塑南,楚菜,素菜,素奈,素那,奏夏,奏花,奏菜,奏渚,奏奈,奏那,奏南,奏和,爽夏,想永,想夏,想七,想奈,想梛,聡那,蒼菜,蒼雫,蒼奈,蒼那,蒼南,蒼梛,宙奈,湊菜,颯菜,颯南
そなた	空詩,空南多,壮向,奏那太,奏鳴歌,蒼空,美冬,颯空
そら	愛空,愛泉,葵空,永空,夏空,空楽,空桜,空詩,空紗,空美,空碧,空夢,空耶,空螺,空來,咲来,桜空,宗愛,十楽,心空,澄星,星花,星海,塑空,楚良,礎礼,素空,素来,奏愛,奏咲,奏桜,奏笑,奏頼,奏蘭,奏來,奏徠,爽,爽愛,爽空,爽晴,爽蒼,爽蘭,想愛,想楽,想蘭,早来,相羅,相来,蒼愛,蒼桜,蒼天,蒼羅,蒼來,宙空,宙来,天葵,天央,天詩,天真,天羅,美空,美蘭,湊愛,夢芽,冥,耀昊,琉羅,恋空,昊愛,昊蘭,翔詩,颯羅
そらち	そらな,空夏,空菜,空成,空奈,空那,空凪,空來,空梛,想良菜,宙成,宙奈,宙和,天菜,天奈,昊菜,昊奈,昊凪,穹和
そらは	空花,空天,空波,空葉,爽葉,天春,天琶,天葉,昊芭
そわ	園笑,十和,曽和,楚和,爽羽
たか	尭,多郁,多加,多可,多嘉,多夏,多果,多歌,多花,多香
たけみ	岳美,健海,健観,健見,健実,健未,健魅,虎美,多景美,茸海,茸光,茸美,竹実
たまお	たまお,環緒,環織,玉央,玉乙,玉音,圭生,珠央,珠音,珠桜,珠織,珠生,珠青,瑞緒,玲央,玲生,瑶緒,瑶生
たまき	たま希,たま季,瑛喜,瑛希,瑛季,瑛妃,環衣,環伎,環岐,環祈,環季,環稀,環記,環桔,環蒔,環妃,環姫,環木,環來,玉葵,玉記,玉輝,玉晶,玉祥,玉生,玉姫,圭輝,圭妃,賜紀,賜記,珠,珠葵,珠伎,珠嬉,珠岐,珠祈,珠稀,珠紀,珠規,珠記,珠亀,珠久,珠妃,珠姫,珠来,珠利,珠來,珠暉,珠綺,進葵,瑞葵,瑞喜,瑞紀,瑞貴,瑞輝,多蒔,多真季,多真樹,多磨紀,多麻紀,多万喜,多茉喜,太真稀,太摩希,太摩稀,太万希,珍亀,碧嬉,碧祈,碧紀,碧姫,碧萌,玲喜,玲嬉,玲祈,玲季,玲姫,玲熙,珀葵,珀希,珀季,珀稀,珀紀,珀己,珀妃,瑶喜,瑶希,瑶季,瑶紀,瑶貴,瑶己,瑶姫,瑶來
ちか	ちか,チカ,愛,愛香,央,懐,茅佳,茅加,茅可,茅夏,茅果,茅禾,茅花,茅華,茅嘩,茅賀,茅叶,茅香,亨,恭,近,慶,史,慈,治佳,治夏,治華,実,周,新,親,尋,誓,誓花,静,戚,千一,千榎,千伽,千佳,千加,千可,千嘉,千夏,千果,千架,千歌,千珂,千禾,千花,千華,千迦,千霞,千賀,千雅,千海,千馨,千叶,千樺,千薫,千袈,千圭,千景,千香,千哉,千楓,千風,千珈,千翔,知伽,知佳,知加,知可,知嘉,知夏,知果,知歌,知禾,知花,知華,知叶,知香,知芳,地下,地価,地花,智郁,智伽,智佳,智加,智可,智嘉,智夏,智果,智歌,智珂,智禾,智花,智華,智賀,智海,智椛,智圭,智香,智神,智翔,池花,稚伽,稚佳,稚夏,稚果,稚華,稚翔,直禾,直香,直翔,椿花,浮,睦,殆,盟,悠,悠花,祐嘉,祐華,力,和,莉佳,莉夏,莉禾,莉花,莉華,莉香
ちかい	千貝
ちかげ	ちかげ,愛華,茅景,千花夏,千華夏,千陽,千翔,知影,稚影,稚景
ちかぜ	ちかぜ
ちぐさ	ちぐさ,茅草,千久佐,千紅沙,千紅咲,千紅紗,知草,智種,稚草
ちせ	ちせ,茅世,茅瀬,茅成,治世,千畝,千勢,千成,千星,千晴,千清,千聖,千惺,知世,知瀬,知星,知泉,智瀬,智星,稚世,竹世,椿赤,莉星
ちせい	茅成,千世,千世衣,千成,千晴,千生,千聖,千貰,千晟,知惺,智聖
ちはや	茅羽夜,千はや,千羽乎,千羽文,千羽耶,千早矢,千巴弥,千波弥,千葉乎,千葉也,千葉耶,千葉弥,千葉矢,知波弥,知芭耶,智羽文,智羽弥,智葉弥,稚快,稚早,稚隼,稚颯,秩早,祐迅,莉早
ちはる	一陽,茅羽流,茅花,茅春,茅昭,茅遥,茅陽,治春,千絢,千羽琉,千羽瑠,千映,千花,千花瑠,千華,千浩,千時,千春琉,千知,千東,千波留,千波瑠,千美,千明,千葉瑠,千櫻,千遙,知華,知美,知遥,知陽,知遼,知令,知遙,智花,智華,智早,智日,智美,智葉瑠,池春,稚春,稚悠,稚遥,稚陽,道桜,薙陽,祐晴,莉桜
ちひろ	茅央,茅寛,茅啓,茅宏,茅広,茅弘,茅紘,茅寿,茅祥,茅尋,茅宙,茅比呂,茅優,茅悠,幸優,治恕,千祥,千ひろ,千絢,千緩,千空,千潤,千恕,千丈,千心,千瑞,千泰,千妃呂,千比呂,千姫,千姫露,千明,千容,千陽,千陽呂,千陽郎,千礼,知央,知寛,知啓,知宏,知広,知弘,知紘,知寿,知潤,知恕,知尋,知聖,知大,知拓,知宙,知妃呂,知比呂,知弥,知優,知宥,知裕,知洋,知昊,知洸,知滉,知皓,智央,智寛,智啓,智景,智広,智弘,智紘,智寿,智尋,智蒼,智宙,智博,智妃路,智優,智宥,智祐,智裕,智洸,稚広,稚弘,稚浩,稚尋,稚日呂,稚優,椿央,莉央,莉光,莉宏,莉紘,莉尋,莉蒼,莉優,莉洋
つかさ	つか沙,夏花咲,丘沙,恭沙,恭咲,恭紗,月夏沙,月花咲,月華咲,月沙,月咲,月傘,月紗,宰紗,采咲,司采,司咲,支咲,詞,束花咲,束彩,束紗,束早,津佳紗,津花咲,津華沙,津笠,津香佐,津香沙,津香砂,津香咲,津香紗,典楽,典紗,都佳沙,都歌紗,都花沙,都花紗,都華咲,都笠,都香沙,都香彩,都香紗,都傘,柄鎖,翼花咲,吏花咲,吏咲,良瑳,緑彩,緑紗,廳
つき	つき,ツキ,月,月葵,月花,月喜,月希,月祈,月稀,月貴,月輝,月咲,月樹,月姫,月綺,告季,津樹,通希,紬希,紬貴,紬生,都葵,都喜,都希,都季,都紀,都樹,都姫,都綺
つくし	つく詩,月空詩,月詞,月詩,月徠梓,尽紫,創詩,筑紫,筑心,津玖紫,津來志,都久志,都久詩,都来詩,土筆
つくも	つくも,月雲,月萌
つづみ	つづみ,月々美,鼓海,鼓己,鼓実,鼓南,鼓美,鼓未,鼓弥,摘々美,都々美
つばさ	つば沙,つば咲,つば紗,羽沙,羽彩,羽紗,津芭沙,津葉下,椿彩,椿才,椿桜,椿紗,椿爽,鶴羽沙,都羽沙,美羽紗,翼彩,翼紗,翼早,翔沙
つばめ	つばめ,つば芽,燕芽,椿芽,椿女,椿萌,翼芽,翼女
てるみ	てるみ,てる美,テルミ,旭海,旭美,映美,栄美,瑛実,瑛美,英実,英美,央実,珂実,珂美,監美,揮美,輝見,輝珠,光珠,光未,晃美,瑳美,史実,灼美,秀実,秀美,彰美,晶美,照観,照見,照珠,照心,照水,照未,照魅,照明,晴美,天留美,日美,明実,明美,耀美,陽美,晄実,晄巳,煌美,熙美
てんし	てんし,天思,天紫,天詞,天賜,白羽
てんり	てんり,典莉,天織,天梨,天麗,塡李,塡理
とあ	永愛,永逢,永遠,遠亜,乙亜,乙愛,乙杏,乙空,乙彩,音安,音杏,音彩,音有,叶彩,叶采,叶夢,采阿,采明,采有,時愛,時彩,釈愛,十亜,十秋,心亜,人彩,仁阿,仁杏,仁空,聡亜,兎愛,杜彩,渡按,渡彩,都逢,都杏,都彩,都和,冬彩,桃愛,桃杏,桃彩,等愛,董空,透逢,透彩,柊空,柊碧,富愛,冨愛,友亜,友愛,友彩,利愛,留亜,留愛,橙愛,翔海
としみ	としみ,叡実,叡美,紀見,紀実,紀美,寿美,淑実,淑美,俊観,俊見,俊実,俊未,俊魅,峻心,智美,登志美,稔美,勇実,勇美,利海,禄弥
とも	公,采萌,十萌,兎萌,斗萌,渡萌,渡茂,登茂,都萌,都茂,冬萌,東萌,透百,那,巴,類,榮
とわ	羽,羽和,永倭,遠永,乙倭,叶倭,時笑,時葉,十杷,十輪,十倭,心和,聡和,兎我,堵環,杜輪,渡環,渡琶,登波,登琶,登輪,都琶,都輪,都倭,冬羽,東我,桃羽,灯倭,燈和,透倭,百環,富我,冨環,冨輪,冨和,遥羽,留羽,留我,留環,留和,礼和
なお	なを,ナオ,愛桜,愛緒,永旺,永音,永緒,永麻,夏央,夏音,夏絃,夏桜,夏緒,夏織,夏凰,夏櫻,巨,亨,梗,菜愛,菜央,菜応,菜旺,菜乙,菜音,菜教,菜弦,菜絃,菜桜,菜緒,菜織,菜臣,菜生,菜尾,菜碧,菜保,菜穂,菜麻,菜陽,菜零,菜和,菜櫻,菜穗,雫桜,七緖,七葵,七桜,七織,七穂,七零,七凰,七櫻,七澪,実,順,渚央,渚音,渚桜,渚緒,尚,尚央,尚応,尚生,尚峯,成央,成音,成渚,成緒,成織,成穂,成雄,直,直央,直緒,直生,直穂,奈緖,奈愛,奈旺,奈音,奈己,奈桜,奈緒,奈織,奈生,奈青,奈歩,奈穂,奈麻,奈陽,奈和,奈穗,那愛,那於,那央,那旺,那音,那絃,那桜,那渚,那緒,那織,那生,那青,那保,那穂,那雄,那陽,那和,那櫻,凪緖,凪桜,凪緒,凪織,凪保,凪凰,薙織,捺桜,捺緒,捺穂,南愛,南桜,南織,南和,南櫻,楠央,如,納愛,納央,納絃,波央,波音,名愛,名絃,名桜,名緒,名織,有,猶,和愛,和桜,和緒,梛愛,梛央,梛応,梛音,梛桜,梛緒,梛織,梛生,梛和
なぎ	ナギ,夏葵,夏凪,椛,菜葵,菜樹,菜凪,菜木,七葵,渚葵,凧,汀,奈葵,奈祇,奈樹,奈木,那祇,那樹,凪姫,波葵,名葵,名樹,名木,和葵,梛葵,梛祇
なぎさ	渚佐,渚叉,渚砂,渚咲,渚紗,なぎ沙,なぎ紗,愛木咲,夏渚,夏凪,椛沙,椛紗,菜葵紗,菜紀彩,菜樹桜,七葵咲,七葵紗,七渚,渚倖,渚叉,渚桜,渚珊,渚早,渚捺,渚美,渚岬,汀沙,汀砂,汀彩,汀紗,奈伎紗,奈岐沙,奈希沙,奈希砂,奈樹佐,奈樹沙,奈渚,那葵沙,那葵咲,那伎沙,那岐沙,那岐咲,那岐桜,那岐紗,那希沙,凪叉,凪珊,凪渚,凪早,凪茶,凪妙,凪里,薙沙,薙咲,名杵沙,名岬,和希紗,和冴,和桜,和紗,和妙,梛佐,梛叉,梛咲,梛早,梛茶,梛岬,梛妙,梛里,颯葵
なごみ	なご実,なご美,菜胡美,菜瑚実,菜心海,菜心実,菜心美,七倖実,暖心,奈胡実,奈瑚美,奈心実,奈心美,那瑚実,那瑚美,南心美,南和,納護深,名胡美,和み,和胤,和観,和結,和見,和湖,和胡美,和瑚美,和実,和珠,和笑,和心胤,和心海,和心美,和深,和水,和瑞,和生,和瞳,和満,和魅,和巳,和明,和彌
なごむ	和
なさ	夏沙,夏采,夏咲,夏紗,菜沙,菜彩,菜冴,菜咲,菜紗,菜冷,七彩,七早,成冴,成咲,奈沙,奈彩,奈菜,奈冴,奈咲,奈桜,奈紗,那沙,那彩,那冴,那紗,凪覚,凪沙,凪彩,凪冴,凪咲,凪紗,南沙,南彩,南冴,南咲,南紗,名冴,和冴,梛彩
なつ	ナツ,夏温,夏空,夏津,夏紬,結月,菜月,菜告,菜通,菜紬,菜摘,菜律,七津,七椿,渚月,奈集,奈通,奈蕾,那柘,南月,南津,波都,名津,名柘,鳴鶴
なつき	なつ喜,なつ希,なつ季,なつ稀,なつ貴,愛月,永津紀,夏伎,夏嬉,夏岐,夏揮,夏橘,夏琴,夏玖,夏月姫,夏色,夏星,夏清,夏着,夏槻,夏紬葵,夏都稀,夏姫,懐希,懐貴,魚月,菜ツ希,菜希,菜季,菜月希,菜嗣,菜樹,菜世,菜津希,菜津季,菜津紀,菜津樹,菜津生,菜津妃,菜津姫,菜槻,菜椿綺,菜摘希,菜摘紀,菜摘生,菜摘來,菜都希,菜都紀,菜都姫,菜綺,七希,七津希,七津稀,七津樹,七紬葵,七都妃,樹月,雪月,長月,奈つき,奈ツ喜,奈卯,奈樹,奈津葵,奈津喜,奈津季,奈津稀,奈津紀,奈津記,奈津玖,奈津如,奈津妃,奈津綺,奈通紀,奈摘紀,奈都葵,奈都喜,奈都希,奈都季,奈都紀,奈都記,奈都樹,奈都姫,那ツ喜,那月稀,那津希,那津季,那津紀,那都喜,那都岐,那都己,凪紬葵,凪都希,捺嬉,捺己,捺妃,捺姫,捺来,南津季,南津稀,波月,苗月,名ツ喜,名津葵,名津希,名槻,名椿木,名都喜,名都希,鳴月,勿月,宥月,和月,來月,梛津稀,梛槻,梛都貴
なつひ	なつひ,夏瞳,夏日,夏妃,夏姫,奈津妃,奈津陽,捺日,捺陽
なな	なな,ナナ,愛々,愛永,愛奈,愛絆,永菜,永奈,永那,永梛,夏々,夏菜,夏渚,夏奈,夏那,夏凪,夏南,茄奈,菜々,菜な,菜愛,菜永,菜央,菜夏,菜花,菜菜,菜七,菜渚,菜称,菜成,菜生,菜雪,菜奈,菜那,菜凪,菜捺,菜南,菜楠,菜波,菜名,菜和,菜梛,字々,七,七々,七愛,七夏,七花,七菜,七七,七渚,七水,七奈,七那,七凪,七捺,七南,七名,七夕,七和,七梛,渚々,渚夏,渚菜,渚七,渚奈,渚凪,成花,成菜,成七,成奈,成那,成和,声菜,雪愛,奈々,奈永,奈夏,奈花,奈菜,奈七,奈成,奈生,奈奈,奈那,奈凪,奈南,奈納,奈波,奈苗,奈名,奈也,奈和,奈來,奈梛,那々,那永,那夏,那菜,那咲,那七,那奈,那那,那凪,那南,那名,那和,凪々,凪夏,凪菜,凪七,凪生,凪奈,凪那,凪南,凪梛,捺々,捺夏,捺七,捺那,南々,南夏,南菜,南七,南奈,南那,南凪,南來,楠菜,楠那,寧菜,寧那,納那,波奈,美奈,苗那,撫々,撫南,名菜,名奈,名那,名南,銘奈,鳴々,梨奈,梨那,和々,和菜,和成,和奈,和那,和梛,來那,梛々,梛菜,梛七,梛奈,梛那,梛凪
ななせ	なな瀬,愛彩,永奈瀬,永那世,永那瀬,永和瀬,永梛瀬,夏々世,菜々瀬,菜々晴,菜々聖,菜生,菜奈世,菜奈瀬,菜奈星,菜那瀬,菜名世,菜名瀬,七々瀬,七々星,七光,七彩,七犀,七菜瀬,七菜星,七施,七汐,七七星,七晴,七清,七生,七雪,七千,七奈世,七那星,七日生,七夕,七梛瀬,七梛星,斜世,奈々瀬,奈々星,奈々晴,奈々聖,奈永瀬,奈夏星,奈菜世,奈菜瀬,奈菜星,奈菜聖,奈奈瀬,奈那瀬,奈名世,那々世,那々瀬,那々星,那々晴,那々聖,那菜世,那菜星,那奈世,那奈星,那那聖,那南星,那名星,凪菜星,凪那星,南々星,南菜世,南七星,南那世,南那瀬,楠奈瀬,虹色,虹星,名菜星,名奈聖,梨々世,和々世,和々瀬,和菜瀬,和奈瀬,梛々瀬,梛々星,梛七星
なみ	なみ,ナミ,愛心,愛美,永海,永実,永未,夏海,夏未,夏巳,魚翠,菜海,菜見,菜光,菜后,菜実,菜珠,菜心,菜水,菜瑞,菜生,菜那海,菜南,菜美,菜文,菜望,菜未,菜巳,菜弥,菜澪,七海,七実,七心,七美,七未,七弥,渚海,渚巳,尚美,成海,成実,成珠,成生,成美,成弥,奈海,奈観,奈見,奈己,奈桜,奈三,奈実,奈珠,奈心,奈身,奈美,奈峰,奈満,奈未,奈魅,奈巳,奈弥,那海,那三,那実,那珠,那心,那美,那望,那未,那巳,那弥,凪海,凪海,凪実,凪生,凪南,凪美,凪未,凪巳,捺心,捺美,南伊,南海,南光,南実,南南,南美,南未,南巳,南弥,波,波海,波実,波翠,波南,波美,波未,波魅,苗実,凡,名桜,名実,名美,名巳,来文,漣,和海,和実,和心,和翠,和美,和妙,來海,來未,梛海,梛見,梛実,梛心,梛水,梛瑞,梛太,梛美,梛未,梛巳
なり	為,響,菜莉,七里,成璃,奈李,奈梨,奈璃,奈里,那李,那理,那里,那俐,那凛,那莉,凪莉,南璃,和里,梛里
なる	ナル,燕,菜留,菜瑠,七流,生,生流,奈流,凪瑠,捺瑠,南留,名流,名瑠,鳴琉,鳴留,鳴瑠,梛琉
なるみ	なるみ,なる実,なる美,ナルミ,愛,愛海,愛弓,愛実,愛珠,愛心,愛深,愛瑞,愛美,愛望,愛未,愛弥,育実,華瑠美,菜流実,菜琉実,菜琉美,菜留海,菜留実,菜留美,菜留未,菜留巳,菜瑠海,菜瑠実,菜瑠美,七留美,七瑠美,成観,成見,成好,成珠,成深,成生,成望,成未,成魅,生実,徳美,奈流実,奈流美,奈留海,奈留見,奈留実,奈留美,奈留未,奈留巳,奈留弥,奈瑠海,奈瑠実,奈瑠水,奈瑠美,那琉海,那留実,那留美,那瑠海,那瑠実,那瑠水,南瑠実,南瑠美,平美,稔美,稔未,稔弥,名瑠実,名瑠美,也実,和瑠美
にき	にき,仁衣,仁喜,仁嬉,仁季,仁紀,仁己,仁妃,仁姫,仁來,仁綺,丹葵,丹稀,丹紀,丹輝,丹姫,丹來,二季,二輝,二来,虹希,虹綺
にじ	にじ,七彩,七色
にちか	にちか,にち華,新央,新智花,仁千花,仁千華,仁千翔,仁知,仁知花,仁知華,仁智花,仁智華,仁年,丹親,丹和,二愛,二千夏,二千果,二千花,二千華,二千賀,二千駈,二千香,二知佳,二智華,二莉花,二莉香,日央,日佳,日加,日夏,日果,日架,日歌,日珂,日花,日嘩,日迦,日雅,日椛,日楓,日風,日悠
にの	似乃,新望,仁乃,仁埜,仁野,丹乃,丹埜,二乃
ねお	音緖,音苑,音穏,音寛,音桜,音穂,音凰,新生,祢央,寧恩,寧桜,稔愛,稔捺,嶺桜
ねおん	永遠,音遠,音温,音穏,音音,音織,希音,子恩,寝音,虹音,寧苑,寧恩,寧穏,峯音,嶺穏,嶺御,錬音
ねむ	ねむ,然夢,祢舞,祢夢,寧夢,眠,眠夢
のぞみ	のぞ美,叶望,希見,希珠,希心,希水,希望叶,希望実,希望美,希味,希未,希魅,希弥,稀,乃希美,乃素実,乃其望,望華,望見,望光,望三,望心,望深,望生,望満,望民,望夢,望弥,未来,未來,夢,夢実,夢美,夢未,臨,臨海,臨美,臨未
のり	ノリ,愛,永,記,教,乃,乃利,乃李,乃梨,乃璃,乃里,乃莉,之利,之梨,之理,之里,之莉,濃里,野理,野里
のん	のん,穏,音,海音,希音,暖,暢,乃音
はおと	果音,春音,芭音,葉乙
はおん	羽恩,羽穏,花穏,波穏,葉恩,葉穏
はつき	羽都樹,映月,初紀,初生,初妃,初姫,初綺,巴月,波月,白月,八喜
はやみ	はやみ,快海,早海,早美,早未,颯美,颯未
はる	羽美,羽楼,映琉,果蕗,果留,花優,花琉,花留,花瑠,華流,華留,桜花,桜空,春風,春璃,初流,晴蕗,巴,杷留,琶流,琶留,琶瑠,白琉,媛,遥良,遥瑠,陽音,陽春,榮,遙瑠
はるか	はる夏,はる華,はる香,ハルカ,愛春香,絢佳,絢加,絢禾,絢花,絢華,絢圭,羽流河,羽琉伽,羽琉花,羽留香,羽瑠嘉,羽瑠果,羽瑠架,羽瑠花,羽瑠華,羽瑠香,栄佳,栄花,永佳,永夏,永果,永花,永華,温加,温可,温夏,温架,温珂,温禾,温花,温香,温和,果流華,花渦,花佳,花加,花夏,花科,花果,花架,花歌,花火,花禾,花霞,花叶,花樺,花香,花奏,花芳,花瑠夏,花瑠香,花瑠楓,花栞,花珈,華伽,華佳,華加,華可,華果,華架,華歌,華禾,華花,華叶,華月紅,華香,華奏,華芳,華和,開花,開香,喜叶,喜香,啓加,啓花,啓叶,啓楓,元香,玄一,玄佳,玄果,玄華,浩佳,浩加,浩歌,浩禾,浩花,浩華,桜伽,桜佳,桜加,桜嘉,桜果,桜禾,桜花,桜華,桜樺,桜香,桜風,始佳,始加,始花,始華,始香,紫陽花,歯流化,時嘉,時夏,時果,時禾,治伽,治佳,治可,治夏,治果,治花,治華,治香,春郁,春伽,春佳,春加,春可,春夏,春夏花,春架,春歌,春珂,春禾,春花,春迦,春霞,春賀,春海,春椛,春空,春薫,春圭,春香,春桜,春芳,春蘭,春麗,昭佳,昭花,昭椛,榛佳,榛果,榛珂,榛花,榛華,榛香,晴,晴愛,晴伽,晴嘉,晴果,晴歌,晴禾,晴花,晴華,晴海,晴馨,晴椛,晴樺,晴薫,晴袈,晴哉,晴奏,青佳,青香,青奏,相佳,相香,大佳,大嘉,大夏,大寡,大果,大歌,大河,大花,大華,大空,大香,大栞,暖佳,暖夏,暖果,暖禾,暖花,暖華,暖椛,暖香,暖栞,知花,知香,東加,東香,日一,日花,日華,日椛,日香,日哉,日和,日翔,波留下,波留加,波留花,波留香,波瑠加,波瑠歌,波瑠花,波瑠華,波瑠叶,波瑠香,八瑠佳,美杏,美佳,美加,美嘉,美果,美歌,美花,美華,美霞,美樺,美香,美神,美日,美翔,媛佳,媛加,媛可,媛嘉,媛夏,媛果,媛架,媛歌,媛花,媛華,媛海,媛叶,媛香,媛奏,媛日,媛楓,芳香,明伽,明加,明可,明夏,明果,明架,明禾,明花,明華,明叶,明香,明楓,悠愛,悠伽,悠果,悠架,悠歌,悠花,悠賀,悠椛,悠樺,悠香,悠奏,葉流加,葉流香,葉琉夏,葉琉歌,葉留夏,葉瑠華,遥羽架,遥嘉,遥果,遥歌,遥華,遥迦,遥海,遥馨,遥椛,遥袈,遥圭,遥鹿,遥日,遥耶,遥琉,遥和,遥栞,遥珈,陽,陽郁,陽榎,陽佳,陽可,陽嘉,陽果,陽架,陽歌,陽禾,陽花,陽茄,陽華,陽菓,陽海,陽叶,陽椛,陽樺,陽香,陽楓,陽芳,陽栞,翼花,立果,立芳,流佳,流果,流歌,流花,良佳,遼嘉,遼架,遼歌,遼華,遼叶,遼樺,遼圭,遼奏,遼楓,遼遥,遼蘭,令佳,令華,令香,令風,晏佳,晏加,晏可,晏禾,晏花,晏華,晏香,櫻佳,櫻花,絆瑠輝,遙伽,遙果,遙歌,遙珂,遙花,遙華,遙迦,遙海,遙香,遙鹿,遙日,遙栞
はるせ	悠泉,遥泉,陽泉
はるひ	はる妃,はる陽,絢響,羽瑠陽,永灯,永妃,永陽,温灯,温日,温妃,温飛,花妃,花柊,花陽,華灯,華妃,華緋,華氷,華未,開灯,開日,開妃,開飛,開柊,原灯,原妃,原緋,玄灯,玄妃,浩灯,浩妃,浩緋,桜琉姫,時灯,時妃,時緋,治英,治日,治飛,治柊,春葵,春雛,春比,春飛,春琵,春姫,春媛,昭妃,榛日,榛飛,榛柊,榛陽,晴妃,晴比,晴緋,晴桧,晴媛,晴氷,大日,大緋,暖妃,暖枇,暖姫,覇瑠陽,波留灯,波留妃,波留陽,波瑠陽,美灯,美日,美妃,美緋,美飛,美柊,美陽,媛美,媛未,媛陽,明柊,悠妃,悠斐,悠比,悠姫,悠媛,葉琉日,葉留日,葉瑠陽,遥響,遥灯,遥姫,遥媛,陽音,陽灯,陽波,陽比,陽緋,陽琵,陽媛,陽未,流灯,流妃,流緋,遼灯,遼妃,遼柊,遼媛,晏日,遙緋,遙飛,遙柊
はるみ	はるみ,はる美,ハルミ,絢未,羽流海,羽琉美,羽留海,羽瑠美,栄光,温実,温心,温水,温美,花実,花美,花瑠美,玄美,浩美,桜海,桜実,桜美,桜満,始美,春観,春見,春女,春心,春深,春水,春翠,春生,春泉,春未,春魅,春緑,春瑠美,榛美,榛未,晴み,晴弓,晴珠,晴泉,晴望,晴未,晴留美,青海,暖珠,暖深,珍美,東水,東美,巴流海,巴琉海,巴留海,波留美,波瑠海,波瑠深,波瑠美,芭瑠美,八瑠美,美望,媛実,媛美,媛未,媛巳,媛弥,明実,明美,明弥,悠光,悠実,悠心,悠美,悠未,悠弥,葉留美,遥己,遥真,遥水,遥望,陽弓,陽己,陽珠,陽深,陽水,陽瑞,陽泉,陽望,陽未,陽弥,櫻美
はれ	羽礼,晴レ,晴礼,晴麗,巴玲,波玲,葉玲
ひかり	ひか梨,ひか理,ひか里,ひか莉,愛莉,一佳璃,一花璃,一花凛,希莉,輝吏,輝梨,輝理,輝里,輝莉,景,光佳理,光佳莉,光海理,光浬,光空,光狩,光織,光哩,光夢,光吏,光璃,光裡,光琉,光涼,光厘,光琳,光玲,光麗,紘禾理,彩,彩里,燦,七色,晶,晶梨,晶理,照利,照吏,照梨,照璃,照里,照莉,星輝,星利,灯伽梨,灯伽理,灯伽莉,灯佳利,灯佳李,灯佳梨,灯佳理,灯佳里,灯佳莉,灯加利,灯加吏,灯加李,灯加里,灯加莉,灯可利,灯可吏,灯可李,灯可理,灯可里,灯可莉,灯夏利,灯夏李,灯夏璃,灯夏里,灯夏凛,灯果利,灯果李,灯果梨,灯果理,灯果里,灯果莉,灯架吏,灯架莉,灯花梨,灯花理,灯花莉,灯華利,灯華李,灯華理,灯華里,灯香吏,灯香里,灯香莉,燈,燈香里,燈香莉,虹,日伽利,日伽吏,日伽李,日伽里,日伽莉,日佳吏,日佳梨,日佳理,日佳璃,日佳里,日佳莉,日加利,日加吏,日加李,日加梨,日加理,日加璃,日加里,日可利,日可吏,日可李,日可璃,日可里,日可莉,日嘉利,日嘉吏,日嘉李,日嘉里,日夏利,日夏李,日夏梨,日夏理,日夏里,日夏凛,日夏莉,日夏凜,日寡利,日寡吏,日寡李,日寡里,日果吏,日果梨,日果理,日果里,日果莉,日架浬,日架梨,日架理,日架璃,日架莉,日歌利,日歌吏,日歌李,日歌里,日珂梨,日禾莉,日花利,日花吏,日花李,日花梨,日花理,日花璃,日花里,日花凛,日花莉,日華利,日華李,日華梨,日華理,日華里,日華麗,日華莉,日迦梨,日迦俐,日叶,日叶梨,日叶里,日輝,日薫里,日香利,日香理,日香里,日香凛,日香莉,日和里,日翔理,日翔里,妃伽李,妃伽梨,妃伽理,妃佳里,妃佳莉,妃加里,妃夏李,妃夏璃,妃夏里,妃夏莉,妃架梨,妃架莉,妃歌梨,妃歌莉,妃花利,妃花梨,妃花理,妃花里,妃花莉,妃華明,妃華吏,妃華梨,妃華璃,妃華里,妃華莉,妃迦梨,妃叶莉,妃圭理,妃香吏,妃香梨,妃香理,妃香璃,妃香里,妃香俐,妃耶莉,斐加理,斐加里,斐夏黎,比伽利,比伽吏,比伽李,比伽里,比伽莉,比佳梨,比佳理,比佳里,比加利,比加吏,比加李,比加璃,比加里,比可里,比可凛,比可莉,比可凜,比嘉利,比嘉吏,比嘉李,比嘉梨,比嘉里,比夏利,比夏李,比夏梨,比夏理,比夏里,比夏莉,比寡利,比寡吏,比寡李,比寡里,比果梨,比果理,比架梨,比架理,比架里,比架莉,比歌利,比歌吏,比歌李,比歌里,比花利,比花吏,比花李,比花里,比花莉,比華利,比華李,比華梨,比華理,比華里,比華莉,比叶里,比香梨,比香理,比香莉,緋加吏,緋可吏,緋夏梨,緋禾俐,緋花梨,緋花璃,緋花里,緋花莉,緋茄梨,緋華梨,緋華莉,緋迦梨,緋狩,飛伽利,飛伽李,飛伽里,飛佳利,飛佳吏,飛佳李,飛佳里,飛佳莉,飛加利,飛加李,飛加梨,飛加理,飛加里,飛加莉,飛可利,飛可李,飛可梨,飛可理,飛可里,飛可莉,飛夏吏,飛果利,飛果吏,飛果李,飛果里,飛架利,飛架吏,飛架李,飛架里,飛花利,飛花李,飛花理,飛花里,飛花莉,飛華利,飛華吏,飛香利,飛香吏,飛香李,飛香里,枇夏里,枇香里,毘迦梨,柊伽利,柊伽李,柊伽里,柊佳利,柊佳吏,柊佳李,柊佳里,柊加利,柊加李,柊加梨,柊加理,柊加里,柊加莉,柊可利,柊可李,柊可梨,柊可理,柊可里,柊可莉,柊夏吏,柊果利,柊果吏,柊果李,柊果里,柊架利,柊架吏,柊架李,柊架里,柊花利,柊花李,柊花璃,柊花里,柊華吏,柊香利,柊香吏,柊香李,柊香里,柊狩,姫夏梨,姫夏莉,姫花里,媛加里,百花綾,明光,曜,曜利,曜吏,曜李,曜里,耀,陽,陽かり,陽愛,陽伽吏,陽佳利,陽佳梨,陽佳理,陽佳里,陽佳莉,陽佳凜,陽加吏,陽加李,陽加理,陽加里,陽可利,陽可吏,陽可李,陽可里,陽夏梨,陽夏理,陽夏璃,陽夏里,陽夏莉,陽果里,陽果凛,陽果莉,陽架哩,陽架璃,陽架莉,陽歌利,陽歌梨,陽歌理,陽歌里,陽珂理,陽珂里,陽禾里,陽禾莉,陽花利,陽花吏,陽花李,陽花梨,陽花理,陽花里,陽花俐,陽花凛,陽花莉,陽華利,陽華李,陽華梨,陽華理,陽華璃,陽華里,陽華莉,陽嘩理,陽迦梨,陽海里,陽叶李,陽叶里,陽香,陽香利,陽香李,陽香梨,陽香理,陽香凛,陽香莉,陽香凜,陽代里,陽日梨,陽日里,陽日凛,陽日莉,陽耶梨,陽梨,陽理,陽里,陽莉,晄,晄浬,晄哩,晄李,晄梨,晄理,晄璃,晄裡,晄里,晄麗,晄莉,晄黎,晄凜,暉梨,暉理,暉莉,暉凜,洸利,洸吏,洸李,洸璃,洸里,燿里,熙凛
ひかる	ひか留,ひか瑠,輝流,輝留,輝瑠,光佳留,晃留,彩,照月,日,日佳琉,日佳留,日可留,日花留,日華流,日香留,妃可瑠,妃嘉琉,妃夏瑠,妃花瑠,妃華琉,妃華瑠,妃香瑠,妃星,比夏瑠,緋可琉,緋夏琉,緋果流,緋果留,緋果瑠,緋花瑠,緋華琉,緋香琉,飛花瑠,美空,姫花留,氷佳琉,陽嘉瑠,陽果瑠,陽花留,陽花瑠,陽華留,陽華瑠,陽香,陽日瑠,晄瑠,洸流,洸瑠,燿,皓琉
ひさき	ひさき,永葵,永季,央季,久姫,玖季,光咲,向葵,広咲,寿喜,寿希,寿祈,寿季,寿姫,寿来,瞳咲,日咲,日咲喜,日咲稀,日紗季,妃沙妃,妃咲,妃咲紀,斐咲,姫咲,百咲,弥姫,悠葵,陽彩希,陽彩稀,陽咲葵,陽咲希,陽咲樹,陽紫,陽紗希,陽岬
ひじり	ひじり,聖梨,聖璃,聖莉,妃二利,妃二里,比二利,比二梨,比二理,比二里,比二莉,緋二梨,陽二梨
ひづき	灯月,燈月,瞳月,日づき,妃月,樋月,姫月,氷月,陽通希
ひづる	ひづる,惹鶴,日弦,日津留,妃弦,妃鶴,比弦,比津流,比津留,比鶴,緋弦,飛鶴,陽弦,陽絃,陽蔓
ひとは	ひとは,一羽,一晴,一覇,一波,一芭,人羽,人葉,仁羽,仁花,仁華,仁波,仁芭,斉羽,斉葉,等羽,等巴,等波,等芭,等葉,瞳羽,瞳花,瞳葉,日都葉,妃采羽,陽十葉
ひな	ひな,ひ菜,ヒナ,葵生,一花,一華,一菜,一生,一奈,一那,一凪,一乃,一梛,夏姫,菊菜,菊奈,久菜,久奈,久凪,響愛,光永,光菜,光奈,光那,紘菜,紘那,雛,雛菜,雛七,雛奈,暖,灯為,灯菜,灯渚,灯奈,灯那,灯南,灯来,灯和,灯梛,燈菜,燈奈,燈那,燈凪,燈薙,燈南,燈和,燈梛,瞳菜,瞳奈,日永,日夏,日花,日華,日菜,日七,日渚,日奈,日那,日凪,日捺,日南,日楠,日鳴,日和,日梛,妃な,妃ナ,妃愛,妃葵,妃夏,妃花,妃菜,妃渚,妃雛,妃生,妃奈,妃那,妃凪,妃捺,妃南,妃納,妃波,妃姫,妃名,妃来,妃和,妃梛,斐奈,斐南,比菜,比七,比奈,比那,比凪,比捺,比南,比名,比梛,緋愛,緋夏,緋菜,緋七,緋生,緋奈,緋那,緋凪,緋薙,緋南,緋名,緋和,緋來,緋梛,飛菜,飛奈,飛那,飛凪,飛和,飛梛,枇夏,枇菜,枇奈,枇那,枇南,枇和,琵菜,琵奈,琵那,琵凪,琵南,琵名,琵梛,柊花,柊華,柊菜,柊七,柊渚,柊奈,柊那,柊凪,柊捺,柊名,柊和,柊梛,桧菜,桧奈,桧那,桧凪,桧南,桧和,姫愛,姫夏,姫花,姫茄,姫華,姫月,姫菜,姫七,姫渚,姫心,姫奈,姫那,姫凪,姫南,姫寧,姫梨,姫和,媛夏,媛菜,媛渚,媛奈,媛那,媛凪,媛南,媛名,媛梛,氷菜,氷凪,氷南,穂,陽,陽愛,陽葵,陽杏,陽永,陽夏,陽花,陽華,陽菜,陽雫,陽七,陽渚,陽成,陽生,陽奈,陽那,陽凪,陽捺,陽南,陽楠,陽納,陽波,陽名,陽来,陽梨,陽和,陽梛,冷那,恋咲,檜奈,檜那,檜名,翔那
ひなか	雛佳,雛加,雛禾,雛花,雛華,雛嘩,雛香,雛那花,灯菜花,燈央,日向夏,日向果,日向花,日菜佳,日菜夏,日菜香,日奈加,日奈花,妃央,妃菜花,妃菜香,妃奈花,妃奈香,妃南花,斐仲,比奈加,緋央,緋奈香,姫菜花,姫奈加,陽央,陽花,陽叶,陽空,陽香,陽菜佳,陽菜果,陽菜珂,陽菜花,陽菜華,陽菜叶,陽菜香,陽菜和,陽心,陽奈佳,陽奈加,陽奈果,陽奈歌,陽奈花,陽奈華,陽奈香,陽那佳,陽那歌,陽那花,陽南歌,陽南花
ひなき	ひなき,一奈輝,雛葵,雛喜,雛嬉,雛希,雛季,雛紀,雛記,雛貴,雛輝,雛菊,雛樹,雛生,雛妃,雛姫,雛木,雛綺,日菜喜,日菜希,日菜樹,日菜妃,日奈紀,日和希,日和綺,妃菜喜,妃菜希,妃菜稀,妃菜樹,妃奈希,妃奈紀,妃奈月,妃那季,妃那月,緋菜樹,緋奈紀,緋南姫,穂祈,陽季,陽紀,陽貴,陽菜葵,陽菜希,陽菜樹,陽菜妃,陽那希,陽妃
ひなせ	ひなせ,ひなた,ヒナタ,愛芽,一菜瀬,一陽,輝愛星,輝天星,光永,向葵,向日葵,雛羽,雛唄,雛詩,雛樹,雛世,雛多,雛妥,雛泰,雛妙,雛夕,暖,暖空,灯那多,日なた,日葵,日夏詩,日向,日向葵,日向奏,日向多,日菜詩,日菜瀬,日菜星,日菜多,日菜汰,日菜妥,日咲,日七向,日笑,日生,日奈詩,日奈多,日奈汰,日奈大,日那樹,日那多,日南葵,日南多,日名汰,日陽,日和,日和多,日和大,日梛世,妃葵,妃夏,妃菜葵,妃菜多,妃菜汰,妃菜妙,妃詩,妃奈詩,妃奈瀬,妃奈多,妃奈汰,妃那汰,妃南汰,妃寧,妃陽,比菜多,比奈樹,比奈多,比奈汰,緋菜多,緋七,緋七多,緋奈瀬,緋奈多,緋那多,緋凪多,飛菜多,枇なた,柊菜詩,柊納多,柊碧,桧奈多,姫詩,姫聖,姫奈,姫奈詩,姫奈樹,夕日向,陽,陽なた,陽愛,陽葵,陽唄,陽音,陽空,陽向,陽向葵,陽菜,陽菜維,陽菜咲,陽菜詩,陽菜樹,陽菜世,陽菜星,陽菜多,陽菜太,陽菜汰,陽菜妥,陽菜樂,陽咲,陽詞,陽詩,陽七星,陽七多,陽星,陽晴,陽奏,陽多,陽汰,陽大,陽暖,陽奈詩,陽奈樹,陽奈世,陽奈瀬,陽奈多,陽奈太,陽那多,陽凪詩,陽南多,陽恋歌,陽和溜
ひなり	ひなり,ひな里,ひな凛,ひな莉,光晴,向日葵,雛,雛吏,雛梨,雛理,雛璃,雛里,雛離,雛鈴,雛麗,雛莉,灯菜莉,燈奈里,日愛,日夏梨,日向梨,日向璃,日菜梨,日菜璃,日菜莉,日成,日成梨,日成里,日晴,日奈梨,日奈里,日奈莉,妃愛,妃音,妃菜理,妃菜璃,妃菜里,妃菜莉,妃成,妃奈利,妃奈理,妃奈里,妃奈莉,斐成,緋愛,緋成,緋奈里,枇音,枇南里,琵成,琵鳴,柊菜里,桧菜莉,桧生,姫也,姫利,穂莉,陽愛,陽音,陽雅,陽菜利,陽菜李,陽菜梨,陽菜理,陽菜璃,陽菜里,陽菜莉,陽成梨,陽生,陽奈理,陽奈里,陽奈莉,陽那璃,陽那里,陽那莉,陽凪里,陽南李,陽南梨,陽南理,陽名里,陽鳴,陽李,陽梨,陽璃,陽鈴,陽凛,陽莉
ひびき	ひび希,一未輝,響衣,響心,響妃,響姫,響來,灯々祈,日々葵,日々嬉,日々紀,日々生,日々姫,日々来,日美紀,日美樹,妃々希,妃々季,妃々紀,妃々貴,妃々輝,妃美乙,妃美希,飛々喜,姫響,百美来,陽美喜,陽美貴,陽美姫
ひろ	海,小恕,灯蕗,日蕗,妃蕗,妃呂,妃露,緋蕗,陽芦
ひろみ	ひろ海,ひろ美,丑美,嘉美,海美,緩美,空美,啓弥,景美,光珠,公美,宏見,宏実,宏朱,宏珠,宏未,広弓,弘心,浩心,浩微,浩未,紘弓,紘実,紘美,寿美,潤実,潤美,恕見,恕三,恕実,恕未,仁美,尋弥,拓美,宙美,天美,日路美,博心,博未,博魅,妃呂己,妃呂子,妃呂実,妃呂美,妃呂未,妃呂弥,妃路己,妃路子,妃路美,妃路未,緋呂美,弥生,佑美,優美,宥実,宥美,宥未,宥弥,祐美,裕雅,裕見,裕未,洋心,洋通,昊實,洸美,洸未
ふう	深生,布宇,布羽,扶羽,普生,芙宇,芙羽,芙卯,芙海,芙胡,芙優,芙有,芙侑,譜愛,譜羽,楓宇,楓卯,楓生,楓優,楓憂,風愛,風宇,風卯,風乃,風有,歩雨,歩優,歩侑,巫羽
ふく	フク,富久,富紅,冨,冨紅,芙玖,芙空,芙紅,風紅,歩空
ふじ	ふじ,芙詩
ふづき	ふづき,阜月,風月,風都希,歩月
ふみ	ふみ,フミ,郁,冊,史,志,章,深望,深緑,吹美,典,冬美,二海,二三,二実,二美,二望,婦美,富海,富観,富見,富実,富心,富美,富未,富魅,富弥,冨美,冨望,冨未,布実,布深,布美,扶実,扶美,普実,普美,符美,芙海,芙光,芙実,芙珠,芙充,芙心,芙深,芙仁,芙水,芙瑞,芙泉,芙美,芙文,芙望,芙未,芙巳,芙弥,譜美,譜未,賦実,賦美,撫美,楓実,楓心,楓美,楓碧,楓未,風海,風実,風心,風美,文,文実,文泉,文美,文弥,編,歩海,歩見,歩実,歩珠,歩心,歩美,歩望,歩未,歩弥,奎,巫実,巫美,迪
ほし	帆子,歩偲,穂子
ほたる	火垂,火樽,星垂,帆多琉,美来琉,美来瑠,歩足,穂足,穂多留,穂琉,明流,絆桜,絆流,絆琉,絆留,絆瑠
ほまれ	星希,星舞玲,星舞恋,穂麻玲,穂茉恋,菩希,宝稀,芳稀,萌希,萌稀,誉莉
まあさ	まあさ,愛麻,真亜沙,真亜紗,真愛沙,真愛咲,真雅紗,真彩,真浅,真麻紗,真明咲,真有沙,舞空咲,舞朝,舞麻,麻亜沙,麻亜咲,麻亜紗,麻阿沙,麻安沙,麻浅,万朝,万麻,眞浅,眞朝,眞麻,茉亜紗,茉愛咲,茉愛桜,茉旭,茉旦,茉朝,茉麻
まお	まお,マオ,愛桜,愛緒,愛生,葵緒,雅桜,希央,希桜,稀央,稀音,実桜,真愛,真於,真央,真旺,真王,真乙,真音,真魚,真絃,真己,真皇,真桜,真渚,真緒,真織,真生,真青,真蒼,真碧,真穂,真鳳,真麻,真陽,真零,真和,真凰,真櫻,舞愛,舞於,舞央,舞旺,舞乙,舞音,舞桜,舞緒,舞織,舞生,舞穂,舞鳳,舞麻,舞和,舞凰,摩音,摩桜,摩緒,摩生,摩和,磨央,磨音,磨桜,磨緒,磨生,磨鳳,麻愛,麻於,麻央,麻旺,麻王,麻音,麻寛,麻桜,麻渚,麻緒,麻織,麻生,麻想,麻保,麻穂,麻鳳,麻陽,麻櫻,万央,万乙,万桜,万緒,万織,万生,万鳳,万陽,万櫻,満央,満桜,満鳳,未乙,優和,麗桜,眞央,眞応,眞旺,眞乙,眞絃,眞御,眞桜,眞士,眞緒,眞生,眞穂,眞鳳,眞邑,眞和,眞櫻,茉緖,茉愛,茉於,茉央,茉旺,茉乙,茉音,茉弦,茉絃,茉桜,茉渚,茉緒,茉織,茉生,茉青,茉捺,茉穂,茉鳳,茉麻,茉陽,茉良,茉零,茉和,茉櫻,茉穗
まおん	真園,真苑,真遠,舞苑,麻園,麻苑,麻遠,麻央胡,麻音,万苑,万恩,満音,眞苑,眞音,苺穏,苺音,茉苑,茉音
まき	まき,マキ,愛希,愛稀,愛貴,愛生,愛妃,愛姫,巻,匡妃,蒔,蒔葵,蒔嬉,蒔希,蒔季,蒔稀,蒔月,蒔樹,蒔木,晶稀,真,真葵,真幹,真喜,真嬉,真希,真揮,真棋,真気,真祈,真季,真稀,真紀,真徽,真規,真記,真貴,真起,真輝,真久,真玖,真芸,真己,真枝,真樹,真城,真生,真妃,真姫,真箕,真木,真来,真來,真暉,真絆,真綺,薪,正希,正菊,舞伎,舞喜,舞希,舞季,舞紀,舞輝,舞玖,舞樹,舞妃,舞姫,舞来,舞綺,牧,牧記,摩季,摩紀,摩起,摩綺,磨希,磨季,磨紀,磨輝,磨樹,磨生,磨姫,麻葵,麻幹,麻企,麻伎,麻喜,麻嬉,麻岐,麻希,麻揮,麻季,麻稀,麻紀,麻記,麻貴,麻輝,麻玖,麻樹,麻生,麻妃,麻姫,麻箕,麻木,麻来,麻綺,槙,末姫,末箕,万喜,万希,万季,万稀,万紀,万記,万貴,万起,万輝,万亀,万樹,万生,万木,万綺,満喜,満希,未綺,優絆,麗輝,眞葵,眞叶,眞喜,眞岐,眞希,眞気,眞祈,眞季,眞稀,眞紀,眞規,眞貴,眞輝,眞樹,眞生,眞妃,眞来,眞來,眞綺,茉葵,茉磯,茉喜,茉希,茉季,茉稀,茉紀,茉記,茉貴,茉輝,茉玖,茉樹,茉生,茉妃,茉姫,茉綺,槇
まこ	まこ,ま子,マコ,愛子,愛心,愛虹,葵子,益瑚,益子,稀子,稀心,蒔瑚,蒔子,蒔心,真,真琴,真乎,真呼,真己,真湖,真胡,真虎,真鼓,真瑚,真好,真幸,真香,真子,真珠,真女,真心,真来,真恋,真來,真琥,誠子,直子,舞湖,舞虎,舞鼓,舞瑚,舞好,舞子,舞心,舞虹,舞恋,摩湖,摩瑚,摩子,磨瑚,磨子,魔子,麻呼,麻湖,麻胡,麻瑚,麻子,麻恋,末呼,末己,末來,万胡,万瑚,万香,万子,万恋,満瑚,満子,優心,眞瑚,眞子,眞心,眞来,眞恋,苺瑚,茉乎,茉呼,茉己,茉湖,茉胡,茉瑚,茉好,茉仔,茉子,茉心,茉虹,茉来,茉恋,茉來
まこと	稀琴,蒔琴,蒔言,真己人,真湖都,真鼓音,真鼓都,真瑚都,真子斗,真詩,真殊,真珠,真小鳥,真心都,真恋音,真恋人,真琥都,舞琴,舞采,舞思,舞寿,摩琴,摩思,磨思,磨詞,麻瑚都,麻采,麻心都,末琴,万琴,万言,万瑚都,万殊,満琴,満言,満瑚都,未琴,眞瑚都,茉紀,茉言,茉瑚都,茉思,茉殊,茉寿,萬琴
まさ	真彩,真咲,真紗,真茶,舞咲,麻紗,麻早,麻茶,万茶,満茶,理,眞佐,眞沙,眞瑳,眞早,眞茶,茉佐,茉沙,茉砂,茉咲,茉紗,茉茶
まさみ	まさ美,愛才美,愛咲美,栄美,雅沙美,雅咲海,雅心,雅生,雅魅,匡実,匡身,匡美,芸美,公美,周美,勝美,昌味,昌未,晶水,晶美,真佐美,真沙美,真沙未,真砂美,真紗海,真紗実,真紗美,真紗未,真紗巳,真紗弥,真粧美,真仁,真善美,真早美,真朝実,真朝美,仁美,征美,成美,政観,政未,政魅,正見,正沙美,正未,聖弓,聖美,誠美,斉美,鷹実,稚美,暢実,暢美,暢未,当美,舞沙美,舞彩実,舞彩美,方美,摩紗巳,麻沙実,麻沙美,麻紗実,麻紗美,万沙美,万咲心,万紗巳,満桜美,優見,優珠,優心,眞佐美,眞実,眞美,茉沙実,茉沙美,茉冴海
ますみ	ますみ,マスミ,愛純,益未,加実,加美,賀美,雅純,潤実,升実,丈実,丈美,新純,真好,真主実,真珠,真珠海,真寿実,真寿未,真淑,真須三,真澄美,真清,賦未,舞淑,舞純,舞澄,摩純,磨須美,麻朱美,麻寿美,麻住,麻淑,麻純,麻須美,麻垂美,麻澄,麻聖,麻遥,万子実,万寿実,万澄美,満純,眞壽美,茉寿,茉純,茉澄,萬純
まとい	真采生,真堵衣,纏依,纏衣,纏唯,舞斗衣,麻音衣,麻都衣,絡意,絡生,茉都衣
まな	まな,マナ,愛,愛永,愛夏,愛空,愛菜,愛七,愛渚,愛心,愛成,愛奈,愛那,愛凪,愛楠,愛名,愛梨,愛和,愛絆,益菜,円梛,学,眼,希花,希奈,希和,稀菜,蒔永,蒔夏,蒔菜,蒔七,蒔奈,蒔那,蒔凪,蒔南,実花,実菜,実那,実凪,実南,慎奈,真,真な,真愛,真永,真夏,真花,真魚,真菜,真字,真七,真渚,真女,真成,真生,真奈,真那,真凪,真捺,真南,真楠,真波,真苗,真名,真銘,真梨,真和,真梛,正菜,舞愛,舞夏,舞花,舞菜,舞七,舞生,舞奈,舞那,舞凪,舞南,舞納,舞波,舞梨,舞和,舞梛,摩菜,摩奈,磨菜,磨七,磨奈,磨名,魔奈,麻永,麻夏,麻菜,麻七,麻渚,麻奈,麻那,麻凪,麻南,麻楠,麻波,麻名,麻和,麻梛,万逢,万永,万菜,万七,万奈,万那,万凪,万楠,万和,満菜,満奈,満那,満楠,満梛,未菜,未奈,未那,未凪,優凪,實菜,實梛,眞菜,眞七,眞奈,眞那,眞凪,眞捺,眞南,眞楠,眞名,眞来,眞來,眞梛,苺奈,苺和,茉逢,茉永,茉夏,茉花,茉菜,茉七,茉渚,茉生,茉奈,茉那,茉凪,茉南,茉楠,茉納,茉波,茉並,茉名,茉和,茉來,茉梛,莉奈
まなつ	まなつ,愛夏,愛月,愛津,愛都,学津,学都,真津,真鶴,真都,真奈月,真奈津,真那月,舞捺,麻夏,万夏,眞津,眞都,茉夏,茉奈津,茉捺
まひる	真日,真日留,真日瑠,真比流,真比留,真比瑠,真緋流,真緋留,真緋瑠,真優瑠,真陽流,真陽留,舞昼,舞日,舞妃留,舞陽,魔陽涙,麻昼,麻日,麻日流,麻比流,麻比留,麻陽瑠,陽向,眞日,茉昼,茉日琉,茉日瑠,茉妃瑠,茉陽琉,茉陽留,茉陽瑠
まひろ	愛生,愛陽,希尋,希洋,希陽,蒔浩,蒔優,実鴻,実尋,実優,真都,真漠,真汎,真凡,真宥,真陽,真翔,舞嘉,舞浩,舞恕,舞丈,舞尋,舞泰,舞宙,舞優,舞宥,舞裕,舞洋,摩恕,磨寛,磨尋,麻緩,麻宙,麻妃桜,麻姫,麻弥,麻優,麻宥,麻陽呂,麻礼,麻滉,万絢,万勲,万浩,万恕,万祥,万都,万宥,満寛,満紘,満尋,満弥,優心,優弥,眞光,眞丈,眞碩,眞汎,眞宥,茉嘉,茉緩,茉潤,茉恕,茉祥,茉丈,茉蒼,茉灯芦,茉日呂,茉埜,茉博,茉妃呂,茉宥,茉陽,茉陽呂,茉礼,茉皓,萬尋
みお	みお,ミオ,愛央,果央,雅音,雅桜,海愛,海於,海央,海王,海乙,海音,海桜,海渚,海緒,海織,海生,海青,海百,海穂,海和,海凰,看音,観央,希緒,見央,見応,見旺,見絃,見尾,己央,己桜,己緒,己生,光緖,光愛,光央,光音,光絃,光桜,光緒,光織,光麻,光陽,光和,光櫻,后陽,好央,好音,好桜,好緒,三央,三音,三桜,三緒,三生,三保,三櫻,史旺,史音,史桜,史緒,史捺,視音,爾音,爾織,実緖,実愛,実於,実央,実応,実旺,実音,実桜,実渚,実緒,実織,実生,実青,実想,実穂,実麻,実陽,実零,実和,実凰,実櫻,珠阿,珠愛,珠央,珠旺,珠乙,珠音,珠桜,珠緒,珠織,珠生,珠和,珠凰,充央,充音,充絃,充緒,充凰,心緖,心お,心愛,心央,心乙,心音,心絃,心己,心紘,心桜,心渚,心緒,心織,心生,心暖,心穂,心麻,心勇,心陽,心零,心和,心凰,心櫻,深愛,深央,深音,深桜,深緒,深織,深生,深青,深想,深碧,深澪,真央,真音,真緒,真織,真生,壬央,壬音,壬桜,壬緒,水愛,水央,水応,水音,水絃,水桜,水渚,水緒,水生,水脈,水和,水澪,翠桜,瑞,瑞央,瑞桜,泉緖,泉緒,泉和,南央,南桜,美緖,美お,美阿,美愛,美烏,美於,美央,美応,美旺,美欧,美王,美翁,美乙,美音,美魚,美絃,美桜,美渚,美緒,美小,美織,美臣,美生,美青,美捺,美穂,美麻,美夜,美有,美雄,美陽,美藍,美零,美和,美凰,美櫻,美澪,美綸,文絃,碧愛,碧央,碧乙,碧音,碧桜,訪央,訪応,訪桜,訪生,望緖,望愛,望央,望旺,望乙,望音,望桜,望渚,望緒,望織,望生,望青,望麻,望陽,望和,満央,満音,満緒,未愛,未於,未央,未旺,未翁,未乙,未音,未絃,未桜,未渚,未緒,未織,未生,未捺,未陽,未和,未凰,未櫻,魅愛,魅央,魅乙,魅音,魅桜,魅緒,巳於,巳央,巳桜,巳緒,巳生,蜜織,湊愛,妙愛,妙音,夢桜,明於,明桜,弥愛,弥央,弥音,弥桜,弥渚,弥緒,弥織,弥生,弥大,弥和,弥櫻,彌愛,彌央,彌桜,澪,澪愛,澪央,澪旺,澪音,澪桜,澪緒,澪生,澪鳳,澪和
みおう	みおう,海桜,光桜,三桜,三櫻,実桜,実凰,珠桜,心桜,心櫻,深央,深桜,美欧,美桜,美扇,美凰,美櫻,碧桜,訪応,訪桜,望桜,未桜,未凰,明桜,弥桜,澪宇,澪羽,澪凰
みおと	海音都,実乙,実吟,心乙,水乙,水音,水音都,美韻,美央乙,美乙,美吟,美桜都,美緒都,未音,魅響,魅桜音,澪杜
みづき	みづ希,海槻,鏡月,見月,御月,光葵,光喜,光季,光紀,光記,光貴,光生,光槻,光木,三葵,三月樹,三津紀,実津季,珠月,翠希,翠月,瑞葵,瑞希,瑞生,聖月,美季,美月喜,美月祈,美月季,美月姫,美津伎,美津稀,美津紀,美津樹,美槻,美鶴季,美鶴樹,美鶴姫,美都葵,美都紀,美都貴,美都樹,碧月,峰月,望月,満月,未月,魅月,實月,巫月,彌月
みな	みな,み奈,ミナ,海愛,海夏,海菜,海七,海奈,海那,海凪,海南,海波,海和,皆,観奈,空那,結絆,見菜,見渚,見奈,見那,見凪,見南,見梛,己菜,己奈,己那,光菜,光奈,光那,光凪,光捺,皇女,咲名,三菜,三奈,三那,史菜,爾那,実愛,実夏,実花,実菜,実七,実成,実生,実奈,実那,実凪,実南,実祢,実波,実名,実梛,珠菜,珠奈,珠那,珠梛,充菜,充那,充捺,心愛,心夏,心菜,心七,心奈,心那,心凪,心南,心梛,心絆,深奈,深那,深名,真奈,身奈,仁奈,壬那,水,水菜,水七,水奈,水那,水無,水和,水梛,瑞菜,瑞奈,生称,生奈,聖夏,泉菜,泉奈,太梛,瞳安,南,南菜,南奈,南梛,美愛,美永,美夏,美花,美菜,美七,美渚,美成,美奏,美束,美直,美奈,美那,美凪,美捺,美南,美祢,美波,美名,美鳴,美来,美梛,平形,碧夏,碧菜,碧雫,碧七,碧声,碧那,碧南,碧納,碧梛,望菜,望七,望奈,望那,望凪,望南,望波,望梛,満那,満鈴,未菜,未渚,未称,未奈,未那,未凪,未捺,未南,未楠,未納,未波,未和,未梛,魅菜,巳菜,巳奈,巳那,箕梛,湊,湊菜,湊梛,妙奈,命奈,命南,弥菜,弥奈,弥那,弥凪,弥南,弥祢,弥名,澪奈
みなみ	みな実,みな美,みな未,ミナミ,海渚美,海成実,海那美,海南,皆海,皆実,皆美,皆望,観奈美,観波,鏡那美,源未,己菜美,御奈巳,光奈美,光南,光波,三菜美,三奈美,三奈未,三南海,実菜海,実菜心,実菜美,実菜未,実菜弥,実成美,実奈海,実奈南,実奈美,実奈望,実那海,実南,実名望,珠南,珠波,珠名美,心永美,心海,心菜海,心菜美,心渚海,心泉,心南,心南実,心南美,心波,深奈実,深奈美,深洋,尽美,水海,水観,水鏡,水見,水実,水翠,水瑞,水波,水美,水未,水魅,翠波,瑞南,聖奈美,聖奈未,南光,南菜実,南菜未,南三,南心,南水,南泉,南奈南,南奈美,南那海,南那美,南凪海,南帆,南美,南未,南實,美永実,美永心,美永未,美永巳,美永弥,美花咲,美海,美菜海,美菜実,美菜未,美菜魅,美七海,美渚心,美成実,美泉,美奈海,美奈己,美奈実,美奈美,美奈未,美奈弥,美那海,美那相,美那未,美凪海,美凪心,美南海,美南実,美南美,美南弥,美波海,美並,美凡,美名実,美漣,碧南,穂奈美,萌波,望菜美,望奈美,望奈未,望凪海,望南,望波,満成深,満波,未永美,未菜海,未菜実,未菜美,未七美,未渚美,未奈実,未那海,未那実,未那美,未凪実,未南,未名美,未洋,未来美,未浪,未梛美,魅波,巳波,岬波,湊珠,湊心,湊南,湊美,湊未,明菜美,弥永美,弥菜美,弥成南,弥奈美,弥那美,弥南,弥洋,陽海,陽美,陽未,緑洋,澪南美
みの	みの,海音,海乃,海之,三乃,実応,実乃,実之,実野,珠乃,心乃,心埜,美心,美乃,美之,美埜,美濃,美能,美望,美野,未乃,未埜,巳乃,巳之,弥乃,弥埜
みのり	みの里,みの莉,愛美,海愛,海以,海祈,海紀,海尋,海乃利,海乃理,海乃里,海乃莉,海之里,観徳,季,季里,結実,見恭,光愛,光雅,光紀,光祝,光哲,光乃里,好穂,三紀,三乃梨,三乃理,三乃里,三乃莉,三倫,実のり,実ノ李,実ノ里,実愛,実寛,実祈,実季,実規,実宜,実矩,実祝,実織,実仁,実知,実智,実祷,実乃浬,実乃織,実乃利,実乃吏,実乃李,実乃理,実乃璃,実乃里,実乃凛,実乃莉,実乃凜,実之利,実之梨,実之理,実之里,実之莉,実穂,実法,実哩,実野里,実遥,実利,実吏,実李,実梨,実璃,実裡,実緑,実倫,実琳,実礼,実鈴,実凛,実稟,実黎,実凜,珠愛,珠紀,珠慶,珠智,珠典,珠乃梨,珠乃里,珠乃莉,珠穂,珠里,珠礼,秋,充実,穣幸,穣李,穣里,心愛,心雅,心紀,心敬,心実,心智,心徳,心乃李,心乃梨,心乃里,心乃凛,心乃莉,心遥,心里,心律,深愛,深祈,深乃梨,深乃莉,深礼,真乃理,仁郷,水紀,水乃里,翠紀,泉紀,年,年里,農里,美の里,美の莉,美ノ李,美ノ里,美ノ莉,美祈,美紀,美規,美騎,美宜,美教,美矩,美慶,美憲,美朔,美詞,美祝,美肖,美仁,美成,美宣,美智,美稚,美哲,美典,美登,美乃,美乃浬,美乃利,美乃吏,美乃李,美乃梨,美乃理,美乃璃,美乃里,美乃麗,美乃俐,美乃凛,美乃莉,美乃凜,美之梨,美之理,美之莉,美能里,美範,美穂,美法,美命,美野梨,美野里,美遥,美利,美梨,美理,美里,美律,美緑,美礼,美莉,文紀,穂,穂乃梨,穂利,穂吏,穂理,穂礼,穂莉,萌愛,豊,望愛,望紀,望徳,望乃梨,望乃理,望乃莉,望利,望里,満,満智,満乃梨,満里,未祝,未愛,未祈,未紀,未宜,未恭,未矩,未訓,未慶,未朔,未詞,未識,未実,未順,未乃吏,未乃李,未乃梨,未乃璃,未乃里,未乃凛,未乃莉,未之利,未之李,未之里,未稔,未遥,未乘,未莉,魅乃莉,巳乃梨,巳乃理,巳乃里,巳乃莉,巳之,巳之梨,巳之理,巳之里,巳之莉,箕理,稔,稔梨,稔理,稔倫,稔麟,稔俐,民紀,弥紀,弥乃吏,弥乃梨,弥乃里,弥乃俐,弥乃凛,實,彌恭,眞典,穗,穰
みら	みら,ミラ,海愛,海楽,海空,海羅,鏡,見良,光良,実咲,実等,実羅,実来,実良,実來,珠羅,珠良,珠麗,心愛,心桜,心蘭,心麗,深輝,深羅,深良,泉良,瞳空,美愛,美楽,美輝,美空,美咲,美羅,美裸,美来,美藍,美蘭,美良,美麗,美來,美萊,望愛,満羅,未羅,未来,未蘭,未良,未來,魅羅,魅蘭,弥羅,弥良
みらい	ミライ,海徠,海萊,観礼,希望,見萊,光雷,光礼,三羅依,三来,三徠,三蕾,実来衣,実礼,実萊,珠来,珠來,珠徠,充来,心桜依,心望,心来,心頼,心良以,心徠,心蕾,心萊,深来,深良衣,深萊,壬来,水来,水來,瑞徠,星,南来,美愛,美星,美羅愛,美羅唯,美雷,美蘭,美蘭依,美良衣,美礼,美徠,美禮,美蕾,美萊,望愛,望礼,満星,味蘭依,未桜衣,未瀬,未羅依,未来唯,未良愛,未礼,未莉,未萊,魅頼,魅徠,巳來,夢来,夢來,明來,弥礼,實來,眞礼
みらん	雅蘭,海藍,見蘭,光藍,実夢,実欄,実藍,珠藍,珠蘭,充藍,充蘭,心欄,心蘭,水蘭,瑞蘭,美嵐,文蘭,未らん,未欄,未藍,弥蘭,實蘭,澪蘭
みろ	ミロ,廻蕗,光蕗,実蕗,心蕗,心優,心路,美蕗,美呂,未鷺,未蕗,弥蕗
みろく	深緑,美緑,美禄,已禄
むぎ	ムギ,向葵,睦葵,夢葵,夢岐,夢義,夢來
むつ	むつ,睦都,夢都,六都
むつき	結月,舞月,睦幸,睦姫,夢希,夢月葵,夢月希,夢月季,夢月稀,夢月姫,夢月綺,夢津希,夢津季,夢津紀,夢津記,夢津来,霧都季,陸器,六城,六津希,六槻,六都記,眸月
めぐ	めぐ,愛,愛久,愛公,愛紅,恩,芽育,芽久,芽句,芽玖,芽紅,芽生,芽虹,芽来,芽珀,回,環,恵,恵玖,恵紅,周,巡,旋,瞳久,瞳紅,萌,萌玖,萌紅,夢空,明求,惠,苺紅
めぐむ	めぐむ,愛夢,愛霧,恩夢,恵睦,寵夢,萌,萌愛,萌結,萌紅夢,萌夢,萌霧,惠夢,萠夢
もと	最登,心,萌渡,萌登,萌都,望渡,望登,茂渡,茂登,茂都
もみじ	もみじ,もみ寿,黄葉,椛,椛次,椛蒔,紅蒔,秋,秋葉,萌実路,萌美路
ゆあ	ゆあ,ユア,羽愛,往亜,弓愛,弓彩,弓明,結亜,結娃,結愛,結逢,結葵,結茜,結或,結安,結杏,結羽,結雅,結会,結空,結合,結彩,結称,結蒼,結朝,結碧,結歩,結麻,結明,結有,結和,結曖,光陽,幸愛,雪愛,雪杏,雪空,雪蒼,冬彩,如亜,如愛,如彩,如明,百合,夢亜,夢愛,夢逢,夢葵,夢杏,夢花,夢海,夢空,夢彩,夢天,夢歩,夢明,愉亜,愉愛,癒愛,癒空,諭亜,唯亜,唯愛,唯杏,唯空,唯彩,唯在,唯朱,佑亜,佑娃,佑阿,佑愛,佑空,佑彩,佑蒼,佑歩,佑亞,優亜,優娃,優阿,優愛,優逢,優安,優杏,優雅,優空,優彩,優心,優蒼,優碧,優歩,優明,優有,優藍,優和,優亞,勇愛,友亜,友娃,友愛,友逢,友葵,友彩,友明,宥杏,宥彩,悠亜,悠阿,悠愛,悠葵,悠杏,悠雅,悠空,悠彩,悠蒼,悠歩,悠明,悠有,悠和,憂空,有亜,有娃,有愛,有逢,有杏,有空,有彩,有明,有浴,有和,有亞,柚亜,柚阿,柚愛,柚葵,柚安,柚杏,柚空,柚彩,柚天,柚歩,柚明,柚有,柚和,柚亞,由亜,由愛,由逢,由葵,由絢,由安,由杏,由空,由彩,由青,由明,由有,由和,祐亜,祐娃,祐愛,祐彩,祐歩,裕亜,裕愛,裕雅,裕彩,裕明,裕藍,雄愛,夕亜,夕愛,夕海,夕空,夕彩,恋愛,侑亜,侑愛,侑杏,侑空,侑彩,侑蒼,侑和,搖亜,釉亜,釉愛,釉央,釉彩
ゆあん	ゆあん,結安,結晏,夢杏,唯杏,佑安,佑杏,優愛,有杏,有晏,柚案,由按,由杏,祐安,裕杏,夕杏,釉杏
ゆう	ゆふ,愛,惟宇,惟卯,惟布,弓優,弓有,結雨,結卯,結唄,結運,結歌,結海,結空,結胡,結美,結布,結侑,倖美,幸卯,心,水羽,雪雨,紬宇,紬卯,紬布,湯雨,夢歌,夢有,尤,愉羽,愉生,癒羽,癒雨,唯宇,唯羽,唯卯,唯布,唯優,佑雨,佑萌,佑友,優胡,優汐,優心,優想,優布,優風,優宥,優有,友羽,宥羽,悠卯,悠唄,悠布,悠友,悠憂,有卯,有布,有優,柚宇,柚雨,柚風,柚優,由布,由友,祐雨,祐卯,祐侑,裕卯,裕布,裕憂,遊宇,夕宇,夕雨,夕卯,夕海,夕布,侑雨,侑卯,侑兎,侑布,侑友,釉宇,釉羽,釉卯,釉布
ゆうさ	結沙,結咲,結桜,夢羽咲,夢紗,佑彩,佑咲,佑紗,優沙,優彩,優咲,優皐,優紗,友沙,友咲,友紗,悠羽冴,悠沙,悠彩,悠冴,悠咲,悠紗,有彩,有冴,有紗,柚沙,柚咲,由羽冴,由咲,由桜,由紗,祐紗,裕沙,裕咲,夕彩,夕咲,夕紗,侑沙,侑冴,侑咲,侑紗
ゆうひ	郁妃,郁陽,結一,結宇日,結羽日,結羽妃,結火,結生日,結灯,結日,結妃,結姫,結媛,結優日,酉灯,佑妃,佑緋,佑姫,優羽妃,優羽陽,優生日,優妃,優姫,優媛,優氷,優有陽,友妃,友比,友檜,悠生日,憂妃,有生日,有妃,有檜,柚羽陽,柚日,柚妃,柚柊,柚姫,由羽陽,由妃,祐日,祐妃,祐柊,裕姫,遊妃,雄比,雄緋,雄氷,夕羽妃,夕羽陽,夕雨灯,夕生日,夕灯,夕妃,夕斐,夕桧,夕姫,夕優日,夕憂陽,釉妃,釉柊
ゆうほ	ゆうほ,結穂,夢歩,佑朋,佑萌,佑萠,優惚,優畝,優帆,優保,優萌,友保,友歩,友穂,悠浦,有帆,有鳳,由許,由帆,由穂,裕畝,裕穗,邑歩,夕星,夕帆,夕歩,夕穂,夕穗,侑穂,釉保
ゆうら	結愛,結羽羅,結楽,結咲,結心,夢楽,佑來,優愛,優咲,優心,優来,優蘭,優麗,優麗羅,優萊,勇楽,友咲,有羅,由楽,夕楽,夕羅,侑良,侑來
ゆうり	祐璃,ユーリ,ユウリ,郁莉,結羽梨,結羽里,結羽凛,結羽莉,結浬,結生莉,結佑璃,結友璃,結友莉,結憂莉,結有里,結璃,結涼,結鈴,結麗,結侑里,結稟,夢莉,唯璃,佑離,佑鈴,優羽理,優羽莉,優紀,優織,優生里,優友莉,優有莉,優離,優琉,優琳,優鈴,優麗,優稟,友浬,友利,友厘,友莉,宥理,宥璃,宥里,宥莉,悠宇璃,悠哩,悠友璃,悠流,悠瑠,悠侑里,憂梨,憂璃,憂里,憂莉,有愛梨,有梨,有律,有倫,有凜,柚羽里,柚瓜,柚梨,柚俐,柚凜,由宇璃,由宇里,由布里,由友里,由有莉,由吏,由梨,由俐,祐梨,祐琳,祐凜,遊莉,邑梨,邑璃,邑莉,夕浬,夕織,夕哩,夕鈴,夕栞,夕稟,夕黎,蓉里,蓉莉,侑宇璃,侑羽莉,侑生璃,侑稟,迪稟,釉梨,釉里,釉俐,釉凛
ゆうわ	結有羽,優宇羽,優結羽,優波,友羽,宥羽,宥倭,悠禾,悠倭,誘輪,遊羽,邑羽,邑和,夕羽,釉羽
ゆき	祐希,祐己,ゆき,ユキ,喜,弓葵,弓季,弓稀,弓紀,弓貴,亨,恭,恭岐,恭希,恭気,恭祈,恭季,恭規,恭輝,恭生,恭来,恭綺,薫,結葵,結衣,結乙,結伎,結喜,結嬉,結希,結気,結祈,結季,結稀,結紀,結貴,結輝,結祇,結月,結己,結幸,結樹,結仁,結生,結妃,結姫,結利,結李,結來,結暉,結絆,結綺,言,倖,幸,幸希,幸紀,幸貴,幸姫,幸来,行,行希,行祈,志,詩,恕希,恕気,恕祈,恕季,恕規,恕輝,恕生,恕来,恕綺,水貴,政,雪,雪葵,雪希,雪季,雪姫,千,投,湯季,透,如,如紀,如姫,之,美喜,夢葵,夢希,夢稀,夢貴,夢生,夢妃,夢姫,夢来,愉希,癒嬉,癒希,癒輝,癒樹,癒姫,輸紀,唯葵,唯希,唯紀,唯姫,佑葵,佑希,佑祈,佑季,佑紀,佑規,佑記,佑樹,佑生,佑妃,佑来,佑來,佑奎,佑綺,優葵,優伎,優喜,優嬉,優希,優祈,優季,優稀,優紀,優記,優貴,優輝,優騎,優己,優幸,優樹,優生,優妃,優姫,優萌,優宥,優耀,優来,優來,優暉,優綺,勇樹,勇木,友き,友葵,友乙,友喜,友嬉,友希,友季,友稀,友紀,友規,友記,友貴,友輝,友樹,友姫,友来,友暉,友綺,宥希,宥貴,悠葵,悠喜,悠希,悠気,悠季,悠稀,悠紀,悠貴,悠樹,悠生,悠妃,悠姫,悠来,悠綺,憂伎,憂祈,憂季,憂紀,憂記,憂妃,有葵,有黄,有喜,有嬉,有岐,有希,有祈,有季,有稀,有紀,有規,有記,有貴,有起,有輝,有樹,有生,有雪,有其,有妃,有姫,有来,有綺,柚葵,柚衣,柚伎,柚喜,柚希,柚季,柚稀,柚紀,柚貴,柚輝,柚桔,柚樹,柚妃,柚姫,柚木,柚来,柚來,柚綺,由,由葵,由乙,由伎,由喜,由基,由嬉,由希,由祈,由季,由稀,由紀,由規,由記,由貴,由起,由輝,由結,由己,由枝,由樹,由生,由雪,由妃,由姫,由木,由来,由李,由來,由綺,祐葵,祐伎,祐喜,祐嬉,祐希,祐祈,祐季,祐稀,祐紀,祐貴,祐輝,祐樹,祐生,祐妃,祐来,祐來,祐綺,裕葵,裕伎,裕喜,裕希,裕季,裕稀,裕紀,裕規,裕貴,裕己,裕生,裕妃,裕姫,裕暉,遊希,遊季,雄騎,夕葵,夕喜,夕嬉,夕希,夕祈,夕季,夕稀,夕紀,夕記,夕貴,夕起,夕輝,夕月,夕樹,夕城,夕生,夕槻,夕妃,夕姫,夕木,夕李,夕來,夕暉,夕綺,礼,廉,侑,侑葵,侑衣,侑喜,侑希,侑祈,侑季,侑稀,侑紀,侑記,侑貴,侑輝,侑樹,侑生,侑妃,侑姫,侑来,侑來,侑暉,來,喩喜,釉葵,釉伎,釉喜,釉季,釉稀,釉紀,釉規,釉貴,釉生,釉暉
ゆきじ	維路,往路,起路,恭路,薫路,敬路,結希時,孝路,行路,雪志,優希蒔
ゆず	ゆず,ユズ,弓寿,結杏,結好,結子,結朱,結珠,結寿,結瑞,結津,結鶴,結柚,結鈴,水瑞,禅,夢珠,唯好,唯珠,唯寿,唯柚,唯鈴,佑好,佑朱,佑珠,佑寿,佑豆,優杏,優好,優朱,優珠,優寿,優純,優瑞,優澄,優星,優鶴,優杜,友珠,友寿,友津,友絆,悠厚,悠好,悠朱,悠珠,悠寿,悠鈴,憂好,有珠,有寿,有須,有澄,有鶴,有柚,柚,柚杏,柚好,柚沙,柚子,柚朱,柚珠,柚寿,柚瑞,柚澄,柚津,柚鈴,由好,由子,由珠,由寿,由津,祐好,祐珠,裕好,裕珠,裕寿,遊子,遊洲,夕珠,夕寿,夕瑞,侑紗,侑朱,侑珠,侑寿,侑澄,侑津,侑瞳,橙,釉好
ゆずき	ゆず季,右寿生,柑希,結月,結好,結好伎,結好希,結好生,結朱妃,結珠姫,結寿伎,結寿希,結寿稀,結寿貴,結寿樹,結寿生,結澄希,結杜伎,結杜生,譲嬉,譲季,譲紀,譲来,譲綺,雪月花,紬好伎,紬寿伎,紬寿希,紬寿生,紬寿来,紬杜伎,癒月,唯好,唯好伎,唯寿伎,唯寿希,唯寿生,唯寿来,唯津生,唯杜伎,佑好,佑好葵,佑好喜,佑好祈,佑好季,佑好稀,佑好規,佑好記,佑好貴,佑好生,佑珠伎,佑珠祈,佑珠季,佑珠来,佑珠來,佑寿希,佑寿紀,佑寿規,佑寿記,佑寿姫,佑寿来,佑都伎,佑都希,佑都生,優好,優珠季,優珠桔,優珠妃,優珠來,優寿季,優寿生,優雛希,優津紀,優杜来,友好伎,友好希,友好祈,友好季,友好規,友好輝,友好生,友好綺,友珠希,友珠紀,友珠規,友珠記,友寿伎,友寿希,友寿生,友寿来,友寿暉,友樹生,友澄伎,友澄生,友津祈,友津生,友杜伎,友杜暉,友都伎,友都祈,友都季,友都紀,友都記,悠好,悠好伎,悠好希,悠好祈,悠好季,悠朱希,悠珠妃,悠寿伎,悠寿喜,悠寿希,悠寿生,悠寿来,悠瑞貴,悠津生,悠杜伎,憂好,有好葵,有好伎,有好喜,有好稀,有好紀,有好貴,有好生,有珠希,有珠祈,有珠季,有珠紀,有珠生,有珠来,有寿生,有寿來,有津伎,有津祈,有杜來,有都伎,有都希,有都祈,有都季,柚乙,柚桔,柚月葵,柚好,柚好伎,柚好祈,柚好季,柚好紀,柚好記,柚好來,柚咲,柚子葵,柚子喜,柚子希,柚子季,柚子稀,柚子紀,柚子規,柚子貴,柚子生,柚子姫,柚珠伎,柚珠希,柚珠季,柚珠稀,柚珠來,柚寿希,柚寿祈,柚寿季,柚寿紀,柚寿生,柚寿妃,柚寿姫,柚寿来,柚寿來,柚瑞季,柚雪,柚津伎,柚杜來,柚妃,柚姫,柚氣,由好,由好葵,由好伎,由好喜,由好希,由好稀,由好記,由好貴,由好生,由好綺,由珠伎,由珠祈,由珠季,由珠紀,由珠來,由珠綺,由寿葵,由寿伎,由寿喜,由寿紀,由寿規,由寿生,由寿暉,由澄生,由津祈,由杜伎,由杜規,由杜暉,祐好,祐好伎,祐好祈,祐好季,祐好紀,祐好記,祐好來,祐珠伎,祐珠季,祐珠來,祐寿希,祐寿祈,祐寿季,祐寿紀,祐寿生,祐寿来,祐寿來,祐津伎,祐杜來,祐都生,裕好,裕好伎,裕好希,裕好生,裕子希,裕寿伎,裕寿生,裕鶴貴,裕杜伎,裕杜生,夕葵,夕好葵,夕好伎,夕好喜,夕好希,夕好祈,夕好季,夕好稀,夕好紀,夕好貴,夕好輝,夕好樹,夕好綺,夕朱姫,夕珠,夕珠葵,夕珠喜,夕珠祈,夕珠季,夕珠稀,夕珠規,夕珠貴,夕珠輝,夕珠生,夕珠来,夕寿伎,夕寿希,夕寿祈,夕寿季,夕寿生,夕寿姫,夕寿来,夕寿來,夕寿暉,夕樹伎,夕樹生,夕澄伎,夕澄希,夕澄生,夕澄来,夕蒼,夕津葵,夕津伎,夕津喜,夕津稀,夕津紀,夕津規,夕津貴,夕津生,夕津暉,夕杜伎,夕杜來,夕杜暉,夕都希,夕都紀,夕都規,夕都記,侑好葵,侑好喜,侑好希,侑好祈,侑好季,侑好稀,侑好紀,侑好規,侑好記,侑好貴,侑朱貴,侑珠伎,侑珠樹,侑珠生,侑珠来,侑珠來,侑寿伎,侑寿祈,侑寿季,侑寿紀,侑寿來,侑津伎,侑杜伎,侑杜季,侑杜來,侑都伎,侑都生,橙季,讓希,釉好,釉好伎,釉好希,釉好生,釉寿伎,釉寿生,釉杜伎,釉杜生
ゆづる	夢鶴,有弦,有鶴,柚鶴
ゆめ	ゆめ,惟梅,希望,弓愛,弓芽,弓目,結愛,結芽,結女,結梅,結萌,結麻,結夢,結命,結明,結苺,結萠,幸女,紗芽,心結,心夢,努,夢,夢愛,夢芽,夢叶,夢恵,夢女,夢姫,夢萌,夢明,夢苺,愉芽,愉萌,癒芽,癒萌,唯愛,唯芽,唯梅,佑愛,佑芽,佑梅,佑萌,佑麻,優愛,優芽,優恵,優女,優瞳,優萌,優夢,優明,優萠,勇愛,友愛,友芽,友萌,友麻,友要,宥愛,宥芽,宥夢,悠愛,悠芽,悠恵,悠梅,悠萌,悠夢,憂梅,有愛,有芽,有梅,有萌,有麻,柚愛,柚芽,柚女,柚萌,柚明,由愛,由芽,由女,由梅,由萌,由麻,由夢,由明,祐芽,祐女,祐萌,裕愛,裕芽,裕恵,裕萌,裕麻,遊愛,遊芽,邑萌,夕愛,夕芽,夕恵,夕梅,夕萌,幼愛,侑愛,侑芽,侑恵,侑女,侑瞳,侑梅,侑萌,侑目,釉芽,釉萌,釉麻
ゆめじ	夢詞
よう	依羽,佳羽,昇,美羽,与侑,誉羽,洋雨,葉佑,葉侑
らいか	らいか,らい華,楽生可,月華,月奏,桜詩,夢叶,羅衣華,羅衣香,羅華,来以加,来以可,来伽,来佳,来加,来可,来嘉,来夏,来果,来歌,来珂,来禾,来花,来賀,来海,来叶,来香,来楓,頼佳,頼架,頼花,頼華,頼香,礼夏,礼果,礼華,麗華,來衣花,來郁華,來伽,來佳,來加,來嘉,來夏,來歌,來火,來花,來華,來嘩,來芽,來海,來叶,來椛,來香,來日,來蘭,禮歌,莉香,蕾夏,蕾果,蕾歌,蕾花,蕾華,蕾叶,蕾風,黎華,萊夏,萊果,萊華,萊蘭
らいち	楽依智,蘭苺
らいむ	愛夢,楽依夢,楽衣夢,羅伊矛,羅依夢,羅衣夢,雷夢,蘭依舞,麗夢,來,來莞夢,來彩,來心,來眸
らいら	らいら,ライラ,楽依羅,楽依良,楽衣羅,楽衣来,楽衣良,楽井良,羅藍,来依良,来桜,来笑,来羅,来来,来蘭,頼羅,梨良,礼蘭,礼良,來咲,來羅,徠羅,徠良,蕾愛,蕾良
らいり	羅威里,羅唯莉,来理,来璃,来莉,頼理,雷玲,雷莉,蘭衣梨,來利,來梨,來璃,來里,來麗,來凛,來莉,徠李,徠理,蕾理,蕾凛,萊理,萊麗,萊莉
らいる	らいる,楽衣瑠,来衣瑠,来琉,来留,良衣瑠,來輝,來留
らん	らん,ラン,楽音,乱,嵐,欄,藍,蘭,蘭音,覧,良音,來,萊杏
りあ	りあ,リア,綾愛,浬愛,彩純,織愛,虹雫,哩愛,哩茜,有空,利亜,利阿,利愛,利杏,利空,利有,吏亜,吏阿,吏愛,吏逢,吏会,吏吾,吏彩,吏明,李亜,李娃,李阿,李愛,李逢,李空,李合,李彩,李明,李有,李和,梨亜,梨阿,梨愛,梨逢,梨葵,梨梓,梨安,梨杏,梨会,梨空,梨彩,梨明,梨有,梨藍,梨和,理亜,理阿,理愛,理逢,理安,理杏,理雅,理空,理彩,理明,理有,理和,璃亜,璃娃,璃阿,璃愛,璃逢,璃杏,璃海,璃空,璃彩,璃桜,璃充,璃歩,璃明,璃藍,裡亜,里亜,里阿,里愛,里逢,里空,里彩,里編,里明,里有,里和,里亞,琉愛,琉明,亮愛,凌愛,涼愛,涼心,倫愛,厘亜,琳愛,怜愛,麗亜,麗愛,麗逢,麗安,麗杏,麗空,麗彩,麗曖,俐亜,俐愛,俐彩,俐歩,俐有,凛亜,凛愛,凛葵,凛茜,凛安,凛杏,凛空,凛彩,凛桜,凛朱,凛碧,凛歩,凛明,凛和,凛綺,稟愛,稟杏,稟空,綺愛,莉亜,莉娃,莉阿,莉愛,莉逢,莉葵,莉綾,莉安,莉杏,莉空,莉彩,莉采,莉朱,莉碧,莉明,莉有,莉藍,莉和,莉亞,莉曖,黎亜,黎愛,黎空,凜愛,凜杏,凜空,凜彩,凜和
りある	李愛瑠,理愛琉,璃在,玲在
りあん	りあん,浬杏,織杏,哩庵,利安,李安,李杏,梨亜,梨安,梨庵,梨杏音,梨晏,璃愛,璃愛華,里安,里按,里杏,涼杏,鈴杏,鈴晏,麗杏,俐愛,俐杏,絆,絆逢,莉愛音,莉愛華,莉安,莉庵,莉晏,凜庵,凜杏
りお	り央,浬烏,浬乙,浬渚,浬麻,浬和,鯉緒,哩愛,哩於,哩小,哩凰,利愛,利乙,利絃,利織,利百,利夫,利保,利穂,利櫻,吏乙,吏絃,吏渚,吏緒,吏織,吏穂,吏麻,李緖,李於,李絃,李穂,李穗,梨愛,梨於,梨旺,梨王,梨乙,梨恩,梨絃,梨御,梨渚,梨小,梨織,梨百,梨保,梨零,梨和,理緖,理絃,理渚,理臣,理青,理想,理穂,理和,理凰,理櫻,璃緖,璃於,璃御,璃思,璃渚,璃百,璃穂,璃良,璃零,璃凰,裡音,裡御,里緖,里愛,里於,里乙,里音,里魚,里弦,里絃,里渚,里推,里生,里壮,里尾,里百,里保,里穂,里良,律音,律桜,率央,琉愛,琉緒,琉生,琉凰,倫桜,倫生,厘旺,林修,琳央,琳音,琳緒,瑠桜,瑠織,瑠凰,玲央,玲音,鈴央,鈴音,鈴桜,麗乙,麗音,麗桜,麗緒,麗織,恋乙,俐桜,俐織,俐穂,凛乙,凛乎,凛汐,凛渚,凛織,凛捺,凛麻,凛陽,凛零,凛櫻,稟愛,稟央,稟音,稟桜,稟緒,稟生,莉緖,莉応,莉穏,莉丘,莉絃,莉皇,莉渚,莉想,莉百,莉碧,莉保,莉鳳,莉麻,莉櫻,凜愛,凜旺,凜乙,凜桜,凜渚,凜緒,凜織,凜生,凜和,凜櫻
りおん	リオン,桜音,楓姫,碧凪,夢姫,利愛武,李苑,李媛,梨円,梨園,梨苑,梨遠,梨穏,梨媛,理円,理央,理想,璃央音,璃桜,璃媛,里暖,里媛,流音,厘音,林音,瑠音,鈴音,麗穏,麗音,麗桜,凛,凛円,凛薗,凛桜,凛媛,稟恩,稟音,綸音,莉宛,莉杏,莉円,莉園,莉旺,莉緒夢,莉姫,莉媛,凜苑,凜穏,凜桜,凜媛
りず	りず,愛絆,利珠,李珠,李瑞,梨珠,梨寿,梨逗,理珠,理寿,理鈴,璃珠,璃寿,璃純,璃水,璃瑞,璃杜,里珠,里寿,里鈴,瑠璃,鈴珠,麗珠,俐珠,凛珠,凛寿,凛柚,凛鈴,莉月,莉珠,莉寿,莉瑞,莉鶴,莉鈴,凜珠
りずむ	リズム,綾澄,音符,音夢,響,奏,姫音夢,陽音,李音,梨寿夢,梨澄,梨鶴舞,理都夢,裡須夢,里寿夢,里澄,律夢,立夢,輪鈴夢,凛樹舞,莉純夢,莉澄,莉津夢,莉途夢
りつ	織津,織都,利椿,梨紬,理紬,璃紬,里都,里椿,里紬,里鶴,麗津,麗斗,凛紬,莉椿,莉律,黎津,凜津,凜摘
りと	リト,利采,利留,吏兎,李留,梨乙,梨兎,梨桃,理叶,理柊,麗采,麗透,凛乙,凛徒,莉乙,莉富,凜乙,凜兎,凜歩
りょう	綾羽,心陽,梨耀,涼雨,糧,緑羽,凛葉,莉陽
りん	リン,音,心凜,利,梨杏,梨音,理武,璃音,厘,淋,鈴音,鈴蘭,蓮,凛音,凛心,莉夢,凜音,凜名
るあ	月愛,月綾,月彩,光愛,蕗愛,優愛,優心,来愛,流亜,流阿,流空,流天,流明,琉娃,琉絢,琉杏,琉彩,琉藍,琉曖,留亜,留愛,留安,留朱,留有,硫亜,硫愛,瑠娃,瑠逢,瑠絢,瑠杏,瑠雅,瑠彩,瑠碧,瑠明,瑠有,瑠亞,瑠曖,麗愛
るい	月愛,月依,月衣,月希,鷺唯,桜衣,蕗莞,優愛,流,流い,流星,琉似,琉妃,琉癒,留意,瑠愛,瑠音,瑠居,瑠心,瑠星,涙,麗生
るう	るう,月卯,桜愛,流愛,流宇,流卯,流有,琉愛,琉卯,琉海,留愛,留宇,留羽,留卯,留優,留有,瑠愛,瑠宇,瑠卯,瑠海,瑠佑,瑠友,瑠有
るか	月愛,月嘉,月歌,月珂,月花,月華,月嘩,月椛,月香,月奏,巡音,心輝,蕗榎,蕗佳,蕗加,蕗夏,蕗果,蕗架,蕗花,蕗華,蕗霞,蕗海,蕗叶,蕗香,蕗奏,蕗日,蕗楓,踊花,踊華,流榎,流音,流佳,流加,流河,流珂,流霞,流叶,流樺,溜歌,琉愛,琉郁,琉何,琉果,琉茄,琉嘩,琉賀,琉馨,琉樺,琉奏,琉耶,琉蘭,琉栞,留伽,留価,留可,留夏,留果,留架,留歌,留珂,留禾,留花,留茄,留華,留嘩,留賀,留叶,留樺,留香,留奏,留楓,留風,留和,硫香,隆花,龍華,瑠か,瑠一,瑠果,瑠歌,瑠火,瑠茄,瑠嘩,瑠迦,瑠椛,瑠樺,瑠薫,瑠香,瑠神,瑠奏,瑠耶,瑠珈,塁花,塁華,涙花,累奏,炉華
るみ	るみ,る美,ルミ,月海,月心,月美,美,蕗光,蕗実,蕗深,蕗美,蕗未,流見,流光,流実,流水,流美,流未,琉海,琉光,琉三,琉実,琉充,琉心,琉美,琉望,琉満,琉未,琉弥,留海,留観,留見,留己,留実,留珠,留深,留翠,留美,留未,留魅,留巳,留弥,瑠海,瑠見,瑠光,瑠実,瑠珠,瑠心,瑠深,瑠水,瑠美,瑠望,瑠満,瑠未,瑠魅,瑠巳,瑠弥
れい	レイ,戻,令依,令恵,伶愛,伶以,伶泉,怜愛,怜葦,怜唯,玲以,玲位,玲音,玲射,礼惟,礼衣,鈴衣,鈴英,鈴羚,零唯,零礼,霊,麗位,麗惟,麗維,麗衣,麗祝,恋藍,蓮依,蓮衣,蓮玲,澪依,澪衣,禮依,羚以,羚伊,羚意,羚維,羚衣,羚生,莉以,莉伊,莉依,莉意,莉維,莉衣,莉結,莉唯,莉李,黎依,黎衣
れん	恋華,蓮雲,連夢
ろみ	ろみ,ロミ,芦実,心海,蕗光,蕗実,蕗深,蕗美,蕗未,呂海,呂観,呂見,呂実,呂美,呂未,呂魅,路見,路実,路美,路望,露海,露実,露美,露未,露弥,楼心
わおん	羽音,和恩,和穏,和御
わか	わか,愛花,愛香,羽伽,羽佳,羽加,羽夏,羽果,羽架,羽歌,羽珂,羽禾,羽花,羽茄,羽華,羽菓,羽迦,羽叶,羽香,羽風,羽耶,羽珈,環佳,環嘉,環果,環架,環歌,環珂,環禾,環花,環華,環香,吾加,吾歌,吾花,吾華,若,笑佳,稚,稚菜,八花,百華,輪果,輪花,輪華,輪海,輪和,倭加,倭果,倭架,倭歌,倭花,倭華,倭雅,倭香,和愛,和榎,和伽,和佳,和加,和可,和嘉,和夏,和果,和架,和歌,和珂,和禾,和花,和華,和菓,和嘩,和迦,和霞,和賀,和海,和馨,和叶,和椛,和環,和薫,和圭,和香,和奏,和日,和楓,和風,和芳,和耶,和蘭,和珈,和翔,話歌,話花
わかさ	若沙,若砂,若咲,若紗,和佳佐,和佳沙,和佳彩,和佳咲,和佳紗,和加紗,和花咲,和華彩,和香紗
