あいが	亜伊雅,亜衣雅,哀牙,愛一雅,愛夏,愛牙,愛駕,愛香,愛翔,藍夏,藍河,藍牙,藍駕,藍楽,亜伊雅,亜衣雅,哀牙,愛一雅,愛夏,愛牙,愛駕,愛香,愛翔,藍夏,藍河,藍牙,藍駕,藍楽
あいき	亜以己,亜維樹,亜衣希,哀輝,愛揮,愛己,愛築,愛暉,逢喜,逢希,逢季,逢紀,逢輝,逢樹,逢生,会輝,合希,亜以己,亜維樹,亜衣希,哀輝,愛揮,愛己,愛築,愛暉,逢喜,逢希,逢季,逢紀,逢輝,逢樹,逢生,会輝,合希,合気,合桔,瞬輝,心綺,蒼桔,碧希,碧生,明生,藍毅,藍季,藍紀,藍輝,藍樹,藍生,和希,和暉,曖貴,曖己,曖絆
あいく	哀玖,愛駆,愛唯来,逢郁,藍功
あいじ	亜唯児,愛司,愛詩,愛児,愛時,愛治,愛蒔,愛二,逢時,逢仁,相慈,藍司,藍士,藍二
あいと	亜依人,亜依仁,亜惟杜,亜維士,亜衣都,亜弦,亜絃,哀斗,哀翔,愛衣斗,愛一人,愛一飛,愛一翔,愛虎,愛士,愛十,愛人,愛仁,愛生音,愛生心,愛説,愛大,愛兎,愛杜,愛渡,愛途,愛土,愛冬,愛刀,愛統,愛透,愛飛,愛利,逢音,逢叶,逢糸,逢人,逢仁,逢斗,逢登,逢冬,逢翔,会斗,空弦,空生斗,空杜,吾衣翔,吾弦,吾絃,合采,彩人,彩翔,心羽,心音,心人,相人,相斗,相登,相翔,蒼心,碧絃,碧士,碧人,碧大,碧斗,歩叶,明唯斗,藍音,藍叶,藍亨,藍士,藍人,藍仁,藍斗,藍杜,藍飛,藍豊,藍利,藍翔,和惟斗,和音,和絃,和士,和人,和仁,和生音,和斗,和翔,曖衣斗,曖音,曖人,曖仁,曖兎,曖斗,曖渡,曖翔
あいま	亜唯真,愛実,愛馬,逢馬,碧真,藍馬
あお	亜旺,亜夫,亜勇,亜陽,愛旺,愛王,愛勇,逢大,逢和,逢凰,襖,雅生,仰,空弘,空竣,空渚,空織,空青,空大,空雄,空朗,空凰,吾生,昂和,彩央,彩旺,彩勇,彩雄,彩煌,神,青央,扇,蒼士,蒼大,蒼陽,蒼和,蒼凰,天陽,碧旺,碧王,碧士,碧生,碧大,碧和,明推,明生,明和,有生,亞雄,晟大
あおい	亜於伊,亜於衣,亜甥,亜央意,亜央生,亜央李,亜王威,亜王唯,亜乙生,亜乙已,亜御生,亜緒伊,亜生維,亜生唯,亜男威,亜男生,亜男唯,亜尾依,亜尾衣,亜夫維,亜夫衣,亜雄委,亜和伊,亜和衣,亜和一,阿於伊,阿生衣,阿生唯,阿男維,阿男生,阿夫生,阿雄依,阿雄生,阿和衣,愛甥,愛央委,愛央威,愛央意,愛王依,愛乙意,愛乙唯,愛恩生,愛音依,愛音衣,愛桜衣,愛生伊,愛生依,愛生威,愛生意,愛生維,愛男維,愛夫威,愛夫一,愛夫生,愛和生,葵威,葵亥,葵一,葵壱,葵云,葵央,葵乙,葵叶,葵空,葵糸,葵大,絢甥,絢生,綾甥,綾生,粟生唯,安於以,安甥,安生威,安男威,安雄唯,杏生,海生,仰偉,仰威,仰維,仰唯,空男生,吾男生,吾雄依,吾雄唯,彩甥,青位,青偉,青委,青威,青惟,青意,青椅,青郁,青一,青已,扇巳,蒼委,蒼威,蒼意,蒼維,蒼緯,蒼井,蒼一,蒼壱,蒼云,蒼音,蒼絃,蒼士,蒼粋,蒼大,蒼斐,蒼勇,蒼已,碧委,碧威,碧意,碧為,碧医,碧一,碧壱,碧逸,碧云,碧言,碧五,碧射,碧大,碧道,碧妃,明甥,明央偉,明央維,明央生,明王衣,明王生,明温維,明桜生,明織依,明生,明生伊,明生威,明生衣,明男委,明男維,明男生,明男已,明夫委,明夫衣,明和伊,明和衣,有央已,有王生,有生,有生依,有生唯,有男衣,有夫威,有夫維,有勇伊,藍憩,藍大
あおき	葵希,葵貴,葵輝,葵暉,葵絆,空央輝,青喜,青基,青希,青紀,青規,青記,青貴,青軌,青輝,青騎,青己,青樹,蒼葵,蒼央輝,蒼基,蒼季,蒼稀,蒼貴,蒼桔,蒼響,蒼己,蒼生,蒼來,蒼暉,蒼絆,碧喜,碧季,碧紀,碧貴,碧起,碧輝,碧玖,碧城,碧生,碧大,碧來
あおし	亜雄史,葵司,葵史,葵士,葵志,葵獅,葵至,葵詩,葵俊,葵心,仰志,神心,青,青司,青史,青嗣,青士,青志,青獅,青至,青詩,青資,蒼,蒼梓,蒼司,蒼史,蒼嗣,蒼士,蒼始,蒼師,蒼思,蒼獅,蒼至,蒼詞,蒼詩,蒼誌,蒼資,蒼侍,蒼示,蒼識,蒼心,蒼慎,蒼真,碧司,碧史,碧士,碧師,碧志,碧思,碧紫,碧詩,碧誌,碧侍,碧時,碧信,碧心,碧深,碧真,碧神,碧之,藍詩
あおぞら	亜空,葵天,仰空,碧天
あおと	あお斗,亜央士,亜央斗,亜音,亜男都,亜尾斗,阿音,阿尾斗,愛桜音,愛緒斗,愛緒翔,愛生音,愛和人,逢音,葵乙,葵音,葵叶,葵響,葵己,葵士,葵俊,葵人,葵仁,葵大,葵跳,葵兎,葵杜,葵登,葵土,葵飛,葵友,葵翔,安音,海羽,海帆音,開音,仰人,仰斗,仰都,仰翔,空央翔,空音,空桜音,空澄,梧豊,合壮斗,合壮翔,彩央人,彩音,在音,青永,青乙,青音,青叶,青采,青士,青疾,青十,青人,青仁,青澄,青跳,青徒,青斗,青杜,青登,青都,青砥,青冬,青透,青任,青飛,青富,青利,青翔,蒼永,蒼乙,蒼音,蒼叶,蒼兜,蒼絃,蒼虎,蒼采,蒼士,蒼疾,蒼十,蒼人,蒼仁,蒼世,蒼征,蒼大,蒼跳,蒼兎,蒼徒,蒼斗,蒼杜,蒼渡,蒼登,蒼冬,蒼透,蒼隼,蒼飛,蒼富,蒼豊,蒼利,蒼留,蒼和,蒼橙,碧,碧永,碧乙,碧音,碧海,碧叶,碧兜,碧虎,碧采,碧士,碧時,碧秋,碧十,碧人,碧仁,碧澄,碧大,碧兎,碧斗,碧杜,碧渡,碧登,碧砥,碧土,碧冬,碧燈,碧統,碧透,碧任,碧飛,碧富,碧友,碧利,碧橙,碧翔,明音,明緒人,明男斗,明雄人,明和采,有音
あおば	愛生波,愛夫葉,葵晴,葵覇,葵馬,仰羽,仰葉,空和葉,青晴,青把,青馬,扇羽,蒼華,蒼晴,蒼生,蒼馬,碧栄,碧晴,碧生,碧把,碧覇,碧馬
あかし	茜伎,垢司,朱司,朱嗣,朱子,朱志,証士,赤司,赤史,赤士,赤志,丹至,丹心,燈,燈志,緋志,明司,明史,明士,明志,明日士,有加紫
あき	亜暉,阿基,阿樹,安毅,雅輝,介,椛,義,享,尭,空稀,空貴,空樹,空来,謙,顕,吾起,昂輝,晃,彩貴,彩軌,彩綺,在來,秋貴,秋輝,秋樹,充紀,充貴,淳,昭,照,信,新,翠,聡,暖来,著,哲,天喜,天秋,碧月,明貴,明樹,明耀,明暉,耀,亮,和樹,亞希,暉,暉己,曉,燿,禮,麒
あきお	あきお,亜喜夫,亜希男,亜希夫,亜紀央,亜紀生,亜紀男,亜紀夫,亜紀雄,亜樹男,亜樹夫,亜樹雄,阿基男,阿基夫,阿基雄,阿木男,阿木夫,阿木雄,安輝生,安騎夫,安芸男,安芸夫,安芸雄,映男,映夫,映穂,映雄,瑛穂,輝央,輝生,輝穂,輝雄,義大,暁,暁央,暁生,暁大,暁男,暁夫,暁雄,暁郎,暁應,啓生,啓郎,慧穂,顕男,顕雄,光生,晃於,晃央,晃緒,晃生,晃男,晃夫,晃雄,晃朗,航穂,燦生,秋央,秋王,秋生,秋男,秋夫,秋雄,秋郎,彰生,彰男,彰夫,彰雄,彰朗,彰郎,招雄,昌生,昭央,昭生,昭男,昭夫,昭雄,昭郎,晶央,晶王,晶生,晶雄,章央,章緒,章生,章男,章夫,章雄,章郎,翠生,翠穂,翠朗,壮士,爽士,爽生,爽穂,聡士,聡穂,聡勇,知央,知穂,智穂,哲朗,彬央,彬緒,彬生,彬男,彬夫,彬雄,彬郎,明央,明王,明喜央,明希雄,明桜,明生,明男,明夫,明雄,明朗,明郎,陽音,陽生,陽穂,亮央,亮生,亮夫,亮穂,亮雄,瞭王,諒生,諒夫,諒穂,玲穂,玲雄,礼生,礼穂,朗夫,晟夫,晟雄
あきと	アキト,亜喜人,亜喜斗,亜希人,亜希斗,亜希杜,亜希登,亜希翔,亜揮仁,亜稀人,亜稀斗,亜紀と,亜紀叶,亜紀人,亜紀斗,亜紀翔,亜輝人,亜輝斗,亜己人,阿紀都,愛音,愛希人,愛季翔,愛輝利,愛輝翔,愛秋斗,愛生士,愛斗,愛飛,愛来斗,逢喜人,逢輝人,旭叶,旭寿,旭人,旭仁,旭徒,旭斗,旭登,旭冬,旭飛,旭利,旭翔,安希人,安芸斗,安芸和,叡仁,叡徒,叡斗,叡杜,叡飛,映士,映人,映仁,映斗,瑛永,瑛音,瑛士,瑛人,瑛仁,瑛説,瑛大,瑛斗,瑛登,瑛都,瑛冬,瑛把,瑛隼,瑛豊,瑛悠,瑛翔,央采,旺人,旺門,旺橙,旺翔,介人,覚士,観音,鑑人,希翔,紀仁,輝音,輝空,輝戸,輝士,輝人,輝仁,輝斗,輝登,輝都,輝冬,輝篤,輝飛,輝留,輝翔,義士,義人,義仁,義斗,義杜,尭叶,尭斗,尭杜,尭橙,尭翔,暁音,暁希斗,暁貴,暁士,暁人,暁仁,暁操,暁斗,暁杜,暁登,暁都,暁土,暁冬,暁飛,暁翔,空輝斗,空輝登,空人,空斗,空飛,空翔,啓音,啓人,啓仁,啓聡,啓斗,敬仁,敬斗,顕疾,顕人,顕兎,顕徒,顕斗,顕杜,顕登,顕飛,顕富,吾樹人,光音,光十,光人,光仁,光太,光斗,光登,光都,光飛,光利,光翔,昂士,昂人,昂斗,晃音,晃叶,晃采,晃士,晃疾,晃十,晃人,晃仁,晃兎,晃徒,晃斗,晃杜,晃登,晃都,晃土,晃冬,晃飛,晃富,晃豊,晃翔,在音,察兎,察斗,察杜,察登,察飛,燦采,燦疾,燦仁,燦斗,燦杜,燦飛,士斗,灼徒,灼斗,灼杜,灼飛,愁人,秋輝,秋采,秋士,秋人,秋仁,秋兎,秋斗,秋杜,秋渡,秋登,秋都,秋冬,秋門,秋翔,充輝都,充輝翔,充己斗,淳仁,曙人,彰都,彰音,彰采,彰士,彰疾,彰人,彰仁,彰兎,彰徒,彰斗,彰杜,彰登,彰都,彰飛,彰富,彰豊,彰友,彰翔,昌士,昌人,昌杜,昌登,昌飛,昌翔,昭音,昭叶,昭虎,昭疾,昭人,昭仁,昭兎,昭徒,昭斗,昭杜,昭登,昭飛,昭富,昭利,昭抖,昭翔,晶輝斗,晶士,晶疾,晶人,晶仁,晶兎,晶徒,晶斗,晶杜,晶登,晶途,晶都,晶土,晶透,晶飛,晶富,晶豊,晶翔,照音,照史,照士,照人,照仁,照斗,照土,照翔,章人,章仁,章聡,章斗,章杜,章登,章豊,章翔,紹斗,信人,信仁,信斗,翠音,翠士,翠人,翠仁,翠操,翠斗,翠杜,翠翔,成人,成仁,成隼,聖乙,聖音,聖人,聖斗,聖翔,誠音,誠士,誠人,誠仁,誠斗,誠登,誠翔,詮人,壮音,壮士,壮人,壮仁,壮斗,壮翔,爽音,爽叶,爽士,爽疾,爽人,爽仁,爽兎,爽徒,爽斗,爽杜,爽登,爽飛,爽富,爽翔,聡士,聡人,聡仁,聡斗,聡友,旦斗,知仁,的斗,的杜,的登,哲外,哲叶,哲士,哲疾,哲人,哲仁,哲兎,哲徒,哲斗,哲杜,哲登,哲都,哲飛,哲富,哲翔,白斗,白杜,白冬,白翔,彪叶,彪人,彪兎,彪斗,彪杜,彪登,彪翔,彬叶,彬疾,彬十,彬人,彬仁,彬聡,彬兎,彬徒,彬斗,彬杜,彬登,彬都,彬冬,彬飛,彬富,彬豊,彬翔,楓人,文人,稔仁,明音,明叶,明希人,明希斗,明希都,明希土,明希翔,明紀斗,明輝人,明輝斗,明輝飛,明輝翔,明慧,明士,明疾,明樹人,明十,明人,明仁,明生斗,明生土,明兎,明徒,明斗,明杜,明渡,明登,明都,明砥,明冬,明灯,明燈,明祷,明飛,明敏,明富,明豊,明来人,明利,明橙,明翔,盟人,有希音,有希士,有希人,有輝人,有樹人,雄仁,耀音,耀采,耀士,耀人,耀仁,耀智,耀斗,耀登,耀都,耀飛,耀翔,陽音,陽士,陽人,陽仁,陽太,陽斗,陽登,陽都,陽等,陽飛,陽豊,陽利,陽翔,理人,璃士,璃人,璃仁,璃斗,璃土,璃飛,璃留,璃翔,亮叶,亮士,亮疾,亮人,亮仁,亮兎,亮徒,亮斗,亮杜,亮登,亮都,亮土,亮飛,亮富,亮翔,瞭疾,瞭仁,瞭兎,瞭徒,瞭斗,瞭杜,瞭登,瞭飛,瞭富,諒乙,諒音,諒士,諒十,諒人,諒大,諒知,諒斗,諒都,玲音,玲人,玲斗,玲翔,礼人,礼仁,礼斗,朗音,朗士,朗疾,朗人,朗仁,朗兎,朗徒,朗斗,朗杜,朗登,朗都,朗冬,朗飛,朗富,朗翔,和士,惺土,慊人,昊斗,晄都,晄音,晄叶,晄采,晄士,晄疾,晄十,晄人,晄征,晄兎,晄徒,晄斗,晄杜,晄登,晄都,晄土,晄冬,晄飛,晄富,晄豊,晄翔,晟音,晟士,晟疾,晟人,晟仁,晟兎,晟徒,晟斗,晟杜,晟登,晟都,晟土,晟冬,晟飛,晟富,晟橙,晟翔,暉士,暉人,暉斗,暉登,暉都,暉翔,曉斗,曉橙,曉翔,滉士,滉人,煌音,煌虎,煌采,煌士,煌人,煌仁,煌大,煌斗,煌登,煌都,煌飛,煌利,煌翔,燎斗,燎冬,燿翔,皓士,皓人,皓翔,黎人,黎斗
あきなり	瑛成,瑛也,旺成,旺生,暁哉,暁成,暁也,空成,空也,謙有,顕成,顕也,晃成,晃也,秋成,秋也,彰成,彰也,昭成,照也,紹成,哲也,彬成,彬也,明育,明成,明也,耀也,陽成,陽也,璃成,亮也,瞭成,諒成,諒也,昊成,晟也,滉也,煌也
あきひ	映日,秋飛,璃陽
あきふみ	右典,叡典,映典,映文,瑛史,旺史,旺文,花鳥風月,鑑典,輝史,義史,尭典,暁史,暁文,敬文,憲史,研文,光史,幸典,晃史,晃典,晃文,秋書,秋章,秋文,彰史,彰文,昭史,昭文,晶史,祥史,章史,章文,正典,壮史,爽史,聡史,聡文,値史,哲史,哲文,彬史,明史,明書,明章,明文,陽史,陽典,陽文,璃文,了史,亮郁,亮文,瞭文,諒典,晟史,暉史,皓史,禮史
あきら	亜喜良,亜期羅,亜毅羅,亜紀羅,亜紀良,亜貴楽,亜貴羅,亜貴蘭,亜貴良,亜輝,亜輝楽,亜吉良,亜来羅,阿煌,愛喜楽,愛吉良,愛樹蕾,愛生羅,愛綺羅,逢煌,旭楽,旭羅,旭来,旭頼,旭雷,安岐羅,安輝羅,安欽羅,安芸羅,安芸良,杏葵蘭,杏喜羅,杏煌,威,郁良,右,瑛楽,瑛雷,瑛來,英源,旺,夏,開楽,開羅,開来,開頼,開雷,開良,確,覚,学,鑑,輝瑛,輝羅,享,卿,鏡,尭,暁来,暁頼,暁雷,暁良,吟,空,空輝,空羅,空良,啓煌,景,憲,賢,顕,顕楽,顕彰,吾樹羅,光良,公,昂,晃楽,晃羅,晃来,晃嵐,晃良,晃煌,行,彩晃,士,秋楽,秋空,秋螺,秋藍,秋蘭,秋樂,秋煌,春,曙楽,彰,彰羅,彰雷,彰良,昇来,昇頼,昌,昭,昭楽,昭羅,昭雷,晶楽,晶輝羅,晶頼,晶來,照,照良,祥,章,章楽,章羅,章良,証,信,信良,審良,成,成良,晴,正,誠,全,全雷,全良,爽,聡良,泰,旦,智,聴,諦,諦羅,哲,哲良,徹,東,燈煌輝,日楽,日明,熱輝雷,発,彪,彪良,彪煌,彬楽,彬頼,彬雷,幌,明忌羅,明貴楽,明貴良,明樹羅,明羅,明雷,明蕾,明萊,諭来,諭頼,諭良,有季羅,有樹羅,有木羅,融,耀,耀楽,耀良,陽輝,陽來,璃,璃晃,璃蘭,璃良,亮楽,亮来,亮雷,良,諒,怜,麗良,烈,朗,朗楽,朗頼,亞喜楽,昊,旻,昴,晄来,晄良,晁,晨,晟,晟来,晟良,晢,暉来,暹,曄,洸,滉,煌,燎,燿,璋,皓,聰,證
あくあ	亜虎海,愛久空,愛功明,海空,青空海,明吾
あさき	亜幸,亜佐騎,亜埼,亜紗騎,亜紗樹,旭葵,旭幹,旭基,旭嬉,旭希,旭稀,旭紀,旭貴,旭軌,旭輝,旭騎,旭樹,旭生,元稀,浅紀,旦輝,朝揮,朝樹,朝来,朝暉,麻喜,麻希,麻貴,麻起,麻己,麻樹,明魁
あさぎ	浅葱
あさと	アサト,亜郷,亜慧,亜賢,亜佐人,亜佐登,亜沙人,亜沙斗,亜沙杜,亜砂都,亜冴斗,亜冴翔,亜咲人,亜紗人,亜仁,亜聡,亜理,阿郷,阿冴士,阿智,旭時,旭人,旭仁,旭斗,旭登,安佐人,開里,空聖,空智,元飛,元翔,吾郷,吾賢,吾聖,吾怜,彩郷,彩里,滋士,充賢,浅斗,浅利,聡,蒼慧,旦人,朝音,朝賢,朝戸,朝士,朝人,朝仁,朝斗,朝杜,朝途,朝土,朝飛,朝里,朝翔,日都,麻音,麻人,麻仁,麻聡,麻智,麻兎,麻斗,麻飛,麻翔,明賢,明咲人,明聡,明里,明怜,明惺,有聡,有里,諒人,諒翔,晨人
あさひ	亜佐一,亜佐日,亜佐陽,亜沙斐,亜咲比,亜紗飛,亜小陽,亜爽陽,亜早陽,亜理日,阿佐火,阿佐日,阿佐比,阿佐飛,阿佐陽,阿沙陽,愛佐陽,愛沙妃,愛才陽,愛咲日,愛紗緋,愛紗姫,葵咲陽,旭広,旭冴,旭秀,旭森,旭人,旭大,旭灯,旭燈,旭緋,旭飛,旭柊,旭林,旭翔,安佐緋,安佐陽,安沙飛,杏沙妃,杏紗日,海沙陽,空佐陽,空冴飛,空冴陽,空爽陽,空飛,元燈,元毘,元陽,吾沙日,光皐陽,晃陽,昇冴,昇飛,浅火,浅冴,浅日,浅比,浅飛,浅樋,浅陽,旦光,旦燈,旦緋,旦飛,旦柊,旦桧,朝一,朝啓,朝宏,朝佐陽,朝沙陽,朝冴,朝紗陽,朝人,朝大,朝燈,朝瞳,朝日村,朝日飛,朝博,朝斐,朝躍,朝裕,朝耀,朝燿,麻火,麻宏,麻紘,麻秀,麻人,麻飛,麻氷,麻裕,明旭,明佐日,明佐陽,明沙陽,明彩燈,明彩陽,明咲飛,明史翔,明早日,有佐陽,陽,諒冴,諒秀,諒灯,諒燈,諒日,諒比,諒緋,諒毘,諒檜,礼妃,晨晃,晨飛,晨陽
あした	晨
あしたか	愛鷹
あしゅ	愛手,空朱,吾守
あす	安澄
あすか	亜守加,亜須可,亜須禾,亜須叶,阿須可,阿須夏,阿須賀,阿須香,安須加,安須可,安須賀,安須香,空主加,飛可,飛鳥王,未来,明主加,明須佳,明須加,翌可,翔香
あずま	亜寿馬,梓実,吾妻,春,心東,東,東句,東真,東馬,東麻,明絆磨,雷
あせい	亜成,亜晴,亜生,亜誠,亜誓,亜青,亜惺,亜晟,阿聖,阿誠,旭晴,空晴,吾成,吾生,吾誠,彩星,彩生,天清,天誠,文聖,藍星
あつ	淳,純,篤,敦
あつき	亜槻,逢月,斡奇,斡樹,安津輝,杏月,温葵,温希,温稀,温紀,温輝,貴樹,京希,京輝,京樹,現月,厚葵,厚喜,厚希,厚稀,厚紀,厚輝,厚共,厚己,厚樹,孝基,秋月,秋月光,充葵,充希,充揮,充貴,充輝,充生,充煌,淳葵,淳基,淳稀,淳己,淳暉,純稀,純輝,純樹,純生,昌樹,昌生,晶玖,真樹,石井,暖葵,暖希,暖気,暖稀,暖己,暖生,暖大,忠希,忠樹,徳希,篤葵,篤喜,篤毅,篤祈,篤季,篤稀,篤紀,篤貴,篤輝,篤月,篤己,篤城,篤生,篤槻,篤暉,惇希,惇稀,惇紀,惇貴,惇輝,惇騎,惇月,惇樹,惇生,惇暉,敦葵,敦喜,敦毅,敦紀,敦軌,敦輝,敦月,敦樹,敦城,敦生,敦暉,熱気,豊葵,豊貴,睦記,湊喜,湊貴,湊輝,湊煌,陽月,陸希,陸揮,陸季,陸稀,陸紀,陸貴,陸輝,陸樹,涼希,涼季,涼輝,涼月,涼絆,諄喜
あつし	あつし,アツシ,亜津司,亜津志,亜都志,阿津志,愛都志,渥,渥司,渥士,渥志,斡志,安津志,温,温史,温士,温志,貴史,敬士,功士,厚,厚司,厚嗣,厚士,厚志,厚至,厚信,孝,孝茂,竺,集志,充司,充史,充士,充志,充孜,重,春志,淳,淳司,淳史,淳嗣,淳士,淳志,淳至,淳之,純,純史,純士,純志,醇,暑司,暑嗣,暑士,暑志,昌史,昌志,昌孜,専,暖,暖士,暖二,忠,忠嗣,忠詩,展,徳,徳士,徳崇,督,篤,篤司,篤史,篤嗣,篤士,篤志,篤詞,篤資,篤臣,惇,惇司,惇史,惇嗣,惇士,惇志,惇思,惇資,敦,敦司,敦嗣,敦士,敦支,敦獅,敦至,敦詞,敦資,敦賜,敦次,敦識,敦之,熱,熱司,熱史,熱嗣,熱士,熱志,熱至,濃,富,富士,復,豊史,睦,湊紫,有都志,陸,陸史,陸志,諄,諄史,諄士
あづき	阿月,翠月
あまと	亜実人,雨音,雨仁,海音,海人,海斗,海杜,海冬,海翔,天音,天人,天仁,天斗,天杜,天登,天都,天飛,天和,零翔
あまね	安真音,海士寧,海祢,天弥
あむ	亜武,挙武,明武,和夢
あむろ	亜室,亜夢呂,亜夢露,阿室,愛夢露,吾夢路,明武路,明夢鷺
あもん	亜聞,亜問,亜紋,亜門,阿文,阿聞,阿問,阿紋,阿門,安紋,安門,敢紋,吾文,吾紋,蒼門,天紋,碧紋,明文,亞紋
あやお	絢央,絢男,絢夫,絢雄,綾夫,斐雄,彪生,文夫,紋央,紋生,紋男,紋夫,紋雄,紋郎
あやき	絢喜,絢希,絢季,絢輝,絢樹,綾基,綾機,綾毅,綾起,綾己,綾樹,恵輝,彩基,彩毅,彩樹,彩暉,文葵,紋希,妖希,礼葵,礼希,礼騎
あやと	亜哉人,亜也人,亜也斗,亜耶人,亜耶斗,亜弥斗,亜矢斗,亜矢都,亜矢翔,亜陽斗,阿也斗,阿弥斗,愛也斗,愛也斗人,愛也都,愛矢都,絢永,絢音,絢叶,絢絃,絢采,絢士,絢人,絢仁,絢聖,絢太,絢大,絢堵,絢斗,絢杜,絢渡,絢都,絢土,絢冬,絢燈,絢徳,絢敏,絢豊,絢友,絢利,絢翔,綾都,綾永,綾乙,綾音,綾叶,綾士,綾十,綾人,綾仁,綾大,綾斗,綾杜,綾都,綾土,綾飛,綾友,綾橙,綾翔,安弥斗,郁采,郁秋,郁人,郁仁,郁斗,郁門,郁翔,英音,英士,英斗,英杜,英登,漢仁,恵士,恵人,恵仁,恵聖,恵斗,恵友,恵翔,吾矢仁,吾矢斗,彩永,彩叶,彩士,彩糸,彩十,彩人,彩仁,彩説,彩兎,彩斗,彩杜,彩途,彩燈,彩到,彩飛,彩敏,彩豊,彩也斗,彩矢仁,彩橙,彩翔,采音,采叶,采史,采士,采人,采仁,采斗,采杜,采冬,采燈,采門,采翔,朱音,朱虎,朱人,朱斗,朱翔,純人,純仁,純飛,彰士,彰仁,彰登,章士,章人,章斗,章登,章都,章翔,菖人,斐斗,彪音,彪叶,彪人,彪仁,彪斗,彪杜,彪飛,彪翔,彬斗,彬杜,斌人,文音,文兜,文絃,文士,文十,文人,文仁,文斗,文杜,文登,文都,文燈,文飛,文翔,明也翔,紋士,紋人,紋兎,紋斗,紋杜,紋渡,紋登,紋都,紋土,紋翔,紋詢,有弥斗,妖斗,理永,理人,理仁,理斗,理杜,理翔,礼乙,礼音,礼采,礼人,礼知,礼兎,礼斗,礼杜,礼渡,礼都,礼翔,惠叶,惠士,惠仁,惠登,禮士,綺一,綺絃,綺士,綺人,綺仁,綺徒,綺斗,綺杜,綺都,綺利,綺翔
あゆき	亜結貴,亜幸,亜佑起,亜悠毅,亜裕貴,亜裕生,愛侑,梓侑起,鮎希,鮎之,開之,空喜,渉輝,蒼志,蒼至,蒼之,歩葵,歩基,歩気,歩稀,歩軌,歩輝,歩己,歩樹,歩来,歩暉
あゆと	亜結斗,亜優斗,亜友翔,亜由人,亜由登,亜由都,亜由翔,亜侑人,愛結人,愛結都,愛優斗,愛優都,愛優翔,愛悠斗,愛悠都,愛悠翔,愛雄斗,愛釉翔,鮎人,鮎斗,鮎翔,彩優斗,天憂十,碧翔,歩音,歩叶,歩虎,歩士,歩時,歩十,歩人,歩仁,歩説,歩杜,歩途,歩都,歩友,歩利,歩橙,歩翔,明優音,明優都,有夢斗
あゆむ	步武,步夢,亜結武,亜癒夢,亜佑夢,亜優夢,亜由武,亜由夢,亜祐夢,亜裕夢,亜遊舞,亜侑武,阿由睦,愛結武,愛結睦,愛優夢,愛悠夢,愛由武,鮎武,鮎夢,安結夢,空優夢,空悠夢,空由夢,彩結夢,渉武,渉睦,渉務,渉六,捗,道,碧夢,歩む,歩空,歩向,歩弘,歩志,歩宗,歩生,歩武,歩望,歩務,歩牟,歩矛,歩霧,歩六,明優武,明優夢,有友睦,有由武,陸,遼歩
あらし	亜羅司,亜羅史,愛良史,安良士,改将,改信,改翔,吾良士,山風,疾風,新史,新士,新子,新師,新志,新枝,新慈,新将,新信,新心,新星,新知,新翔,神風,嵐,嵐司,嵐史,嵐嗣,嵐士,嵐志,嵐獅,嵐至,嵐資,翔潤
あらた	亜良多,亜良太,亜良大,阿良太,愛羅太,愛良太,愛良大,安良太,杏良太,改,改丈,改多,改太,改汰,改泰,革,空太,空大,空良多,検,顕汰,吾良太,更,荒太,灼,新維,新起,新建,新巧,新丈,新多,新汰,新泰,新大,新達,新歩,新良太,新逞,明良多,明良大,嵐多,嵐太,嵐汰,嵐大,了太,了茶
あらん	亜漣,娃蘭,阿嵐,愛嵐,逢嵐,葵嵐,安嵐,杏嵐,雅嵐,雅蘭,暁嵐,暁藍,空嵐,顕嵐,吾藍,晃嵐,彩嵐,彰嵐,新嵐,蒼嵐,歩嵐,明蘭,有嵐,和嵐,亞蘭,曖嵐
あり	空理,在里,生,満,有浬
ある	亜琉,或,或琉,安流,安琉,晃輝,合流,在,在瑠,有流
あると	アルト,亜流十,亜流人,亜流斗,亜留人,亜留斗,亜瑠音,亜瑠士,亜瑠人,亜瑠斗,阿流斗,阿留人,阿留斗,愛斗,愛有人,愛流斗,愛留人,愛留斗,愛瑠斗,愛類斗,或音,或叶,或人,或妬,或斗,或杜,或翔,安流人,安流斗,安留人,安留斗,安瑠士,京,空琉斗,空瑠音,空瑠斗,光音,在音,在人,在斗,生翔,歩士,歩寿,歩人,歩仁,歩説,歩杜,歩登,歩都,歩冬,歩燈,歩利,歩瑠斗,歩翔,明流翔,明瑠翔,有音,有疾,有十,有人,有仁,有説,有大,有斗,有都,有留斗,遥翔
あるま	亜流馬,亜留馬,亜隆真,亜瑠真,愛琉真,或真,或先,或馬,或磨,或眞,安琉真,在真,在誠,主馬,天竜馬,歩護,歩実,歩舞,歩満,有馬
あれん	アレン,亜廉,亜漣,亜練,亜連,亜錬,阿蓮,阿錬,逢廉,葵蓮,杏連,空怜,空廉,空恋,空漣,紅蓮,彩廉,在蓮,充漣,蒼廉,蒼漣,蒼蓮,存連,碧蓮,歩蓮,明怜,明煉,有憐,有漣,有練,嵐蓮,藍怜,藍蓮
あろは	亜露羽,安呂葉,有呂波
あんじ	安司,安志,安慈,安次,安滋,安治,安寿,安仁,庵司,庵史,庵士,庵志,庵慈,庵仁,庵路,按思,按侍,杏士,杏志,杏侍,杏児,杏治,杏樹,杏仁,杏二,行時,行二,晏司,晏史,晏士,晏志,晏次,晏爾,晏蒔,晏寿,晏二
あんり	按吏,晏綾,晏吏
いあん	伊庵,偉安,偉案,威安,威庵,惟安,一庵,一晏,居庵
いお	伊王,伊夫,依於,依旺,依生,偉央,偉士,偉緒,偉生,偉夫,偉雄,偉零,偉和,威於,惟緒,惟生,惟和,維央,維旺,維生,維伯,維和,緯生,衣央,衣音,衣生,遺和,育大,一央,一織,一生,一青,壱於,壱旺,壱桜,行緒,生雄,唯臣,唯生,唯了,唯和,勇桜,李凰
いおり	庵織,庵吏,庵李,庵律,庵琉,以央理,以音理,以織,伊央利,伊央吏,伊央璃,伊織利,伊織李,伊勇利,伊雄利,伊雄理,伊雄里,伊和理,依央利,依緒李,依織吏,依生吏,依生理,依雄理,偉央利,偉央李,偉央理,偉央璃,偉広亥,偉雄理,夷桜莉,威央理,威王吏,威織,尉織,惟央利,意居,意識,意織,易央理,易織,維央利,維央李,維央理,維央里,維桜理,維折,維和心,維和李,維和里,緯織,衣音李,衣緒李,衣男里,衣雄李,衣雄理,衣雄璃,衣和理,井織,亥織,郁織,一央織,一央李,一央理,一央里,一王理,一乙利,一桜李,一緒莉,一生李,一和理,壱織,壱織李,居織,五織,功織,至織,粋王浬,生音理,生緒李,生男吏,息織,唯愛莉,唯央璃,唯央里,唯折,唯男理,唯雄莉
いおん	依穏,威穏,一恩,一温,一音,今音,生恩,良音
いく	以空,以来,依空,偉久,偉玖,惟久,維久,衣恭,一玖,一功,壱空,莞玖,五久,五玖,射駆,生久,生琥,侑
いくお	以久男,伊久雄,威久雄,育生,育造,育男,育夫,育雄,育郎,郁央,郁生,郁男,郁夫,郁雄,郁郎,幾央,幾生,幾男,幾雄,行央,行生,征夫,征雄,生竜尾
いこい	良恋
いさ	伊,偉瑳,威左,惟颯,為覚,維才,維紗,郁聖,義,勇
いさき	伊佐樹,伊佐木,緯咲,衣咲樹,潔希,功基,功季,功樹,功来,功暉,武輝,勇希,勇樹,力煌
いさな	維真,義渚,勲七,功真,唯真,勇七,勇成,勇波,已眞
いさみ	伊佐海,伊佐実,伊佐未,伊三美,偉左臣,偉勇心,敢,敢巳,義海,義実,勲海,勲弥,功海,功見,功己,功実,功巳,功弥,浩望,勇胤,勇己,勇心,勇巳,勇湊
いしん	以心,以真,伊心,伊真,伊眞,依心,依真,依芯,偉心,偉晋,偉進,威心,威新,威真,威紳,尉伸,尉辰,惟伸,惟心,惟真,惟辰,為新,為真,維伸,維心,維新,維真,維秦,維臣,維芯,緯心,緯真,衣晨,井心,井新,井真,一心,一真,壱真,壱眞,唯心,唯慎,唯新,唯真
いずほ	出帆,出鵬,出穗,泉輔
いずみ	伊角,伊豆味,惟澄,維純,緯澄,井泉,出己,水,白水,稜己,稜望
いちと	伊千登,伊千都,伊知斗,依千仁,依千斗,依智仁,依智斗,惟智斗,衣知仁,一音,一士,一止,一仁,一千翔,一知人,一智斗,一智利,一杜,一渡,一登,一途,一都,一塔,一透,一道,一隼,一飛,一朋,一豊,一橙,壱音,壱虎,壱十,壱人,壱仁,壱斗,壱杜,壱登,壱途,壱都,壱飛,壱翔,逸人,逸斗,逸翔,市人,市都,市翔,生智翔,都叶,都仁,都斗,都杜,都翔,唯斗,良智斗
いっさ	一佐,一左,一沙,一瑳,一砂,一裟,一彩,一斎,一冴,一作,一朔,一桜,一燦,一紗,一心,一醒,一爽,一翔,一颯,壱佐,壱嵯,壱差,壱瑳,壱砂,壱彩,壱冴,壱咲,壱朔,壱桜,壱紗,壱早,壱茶,壱翔,壱颯,逸嵯,伍沙,伍冴
いっしん	維新,一伸,一信,一慎,一新,一晋,一森,一真,一秦,一紳,一芯,一進,一眞,壱信,壱心,壱慎,壱真,壱秦,壱臣,壱芯,壱進,壱仁,壱眞,逸心,逸新,逸申,逸真,逸進,乙心,乙申,敬心,敬慎,稜心,稜真
いっせい	イッセイ,偉世,偉成,尉成,維惺,一犀,一勢,一征,一成,一政,一星,一晴,一正,一清,一生,一盛,一精,一声,一西,一誠,一誓,一青,一静,一斉,一靖,一惺,一晟,壱犀,壱世,壱征,壱成,壱政,壱星,壱晴,壱正,壱清,壱生,壱盛,壱聖,壱誠,壱誓,壱醒,壱青,壱惺,壱晟,逸世,逸征,逸成,逸星,逸生,逸聖,逸誠,逸晟,敬聖,敬誠,敬惺,伍成,伍誠,市成,樹聖,唯聖,李青,稜征,稜成,稜星,稜晴
いっぽ	一帆,壱歩
いつか	一楓,一風,逸圭,逸克,慈佳,未来,李月香
いつき	逸己,愛葵,愛喜,愛季,愛紀,愛貴,愛樹,愛槻,伊津希,伊津紀,伊槻,伊都樹,依津希,依槻,偉月,偉槻,威詰騎,威月,威槻,威都紀,威都規,威都貴,威都樹,惟槻,意月,維槻,井月,亥月,育瑛,郁月,一衣,一幹,一伎,一喜,一基,一岐,一揮,一旗,一期,一棋,一毅,一規,一記,一貴,一起,一軌,一騎,一祁,一己,一築,一津季,一槻,一来,一利,一來,一暉,一氣,一煌,一絆,壱葵,壱伎,壱喜,壱希,壱旗,壱期,壱祈,壱季,壱稀,壱紀,壱規,壱貴,壱軌,壱輝,壱騎,壱球,壱月,壱己,壱樹,壱城,壱槻,壱綺,壱菫,逸葵,逸喜,逸基,逸幾,逸揮,逸機,逸規,逸起,逸軌,逸騎,逸月,逸生,逸來,逸暉,逸煌,逸綺,乙喜,乙岐,乙祈,乙規,乙記,乙貴,乙輝,乙己,乙暉,乙絆,乙綺,幾月,輝希,居月,敬葵,敬喜,敬希,敬稀,敬紀,敬貴,敬槻,敬煌,厳,厳幹,厳基,厳希,厳輝,厳己,厳樹,厳來,五葵,五希,五季,五規,五輝,五己,五樹,伍伎,伍喜,伍基,伍嬉,伍岐,伍希,伍揮,伍旗,伍棋,伍毅,伍祈,伍季,伍稀,伍規,伍貴,伍軌,伍輝,伍騎,伍碁,伍樹,伍生,伍槻,伍綺,斎幹,斎希,斎紀,斎貴,斎騎,斎樹,斎生,斎槻,慈,慈喜,慈規,慈輝,慈樹,慈生,慈槻,慈来,慈來,樹貴,樹輝,樹生,樹力,樹來,小林,粋月,唯輝,要月,李月,稜葵,稜喜,稜希,稜揮,稜毅,稜季,稜紀,稜記,稜貴,稜起,稜輝,稜騎,稜義,稜桔,稜月,稜樹,稜城,稜生,稜礎,稜大,稜來,稜暉,稜煌,稜絆,稜綺,倭月,已月
いつは	逸映,乙羽,乙晴,敬春,斎巴,斎葉
いつほ	壱歩,壱宝
いづる	以弦,伊絃,依絃,偉弦,威弦,意弦,亥弦,一弦,一絃,壱弦,逸留,射弦,出弦,出流,生流,唯弦,唯絃,唯鶴,倭弦
いのり	伊範,伊律,偉憲,威徳,一典,祈紀,祈恭,祈利,祈凛,唯法,倭礼
いふう	伊風,惟颯,維風,一颯,祈楓
いぶ	伊部,依武,偉武,威武,生武,唯武
いぶき	伊輝,伊夫伎,伊芙生,伊武喜,伊武希,伊武季,伊武規,伊武輝,伊武樹,伊武城,伊舞綺,伊部希,伊風,伊蕗,依生樹,依武希,依楓,依歩樹,偉吹,偉吹樹,偉扶生,偉武貴,偉楓,夷蕗,威吹,威武器,威武希,威舞貴,威舞輝,尉吹,惟希,惟扶生,惟歩希,意歩生,維武輝,維歩希,緯吹,緯蕗,衣生希,衣武紀,衣舞輝,郁吹,郁吹樹,一寿,一生希,一生輝,一生樹,一生李,一武希,一武輝,一楓,一葺,一歩輝,一歩樹,壱吹,芽樹,樹吹,小林,生芽,生武貴,生舞貴,生蕗,聖輝,聖夜誓,泉武輝,蒼生,柊季,桧,彪,彪希,彪生,武,歩輝,夢吹,唯希,唯季,唯吹,唯武生,唯舞起,唯楓生,唯歩季,唯歩生,勇吹,李吹,良蕗,已舞希,昴輝,昴己
うきょう	右京,右恭,右響,宇杏,宇叶,宇京,羽叶,羽京,羽恭,羽響,雨京,雨響,海匡,海響,享匡,享恭,生恭,生響,兎郷,佑京,佑恭,優叶,優京,優恭,優響,憂響,有杏,有侠,有恭,侑杏,侑京,侑恭,侑孝
うしお	宇志生,宇志夫,宇汐,宇潮,丑雄,牛大,牛雄,有司男,有志生,侑潮
うた	宇太,宇汰,宇泰,宇大,羽大,雨楽,卯太,唄太,詠大,詠龍,歌太,海大,詩太,詩汰,初汰,生詩,生太,生汰,優樹,優太,優大,有太,侑汰,頌
うみ	宇生,宇弥,宇實,雲谷,海宇,海波,天海,佑未,友未
うみお	海男,海夫,海雄
うるは	愛琉晴,麗生
えい	叡,影,栄,英生,衛,衛偉,鋭,哉,榮,睿
えいいち	叡一,映一,映市,栄一,栄市,永一,永市,瑛一,瑛壱,瑛都,瑛已稚,英壱,英市,衛一,詠一,鋭一,鋭市,暎一,榮一
えいき	叡生,嬰樹,影樹,映希,映毅,映樹,映暉,栄喜,栄基,栄希,栄毅,栄季,栄紀,栄規,栄記,栄起,栄騎,栄樹,栄槻,永喜,永基,永希,永紀,永規,永記,永貴,永起,永輝,永騎,永己,永幸,永樹,泳希,瑛葵,瑛王,瑛伎,瑛喜,瑛基,瑛希,瑛毅,瑛気,瑛稀,瑛紀,瑛記,瑛貴,瑛輝,瑛騎,瑛己,瑛幸,瑛生,瑛暉,英基,英希,英毅,英気,英季,英紀,英貴,英輝,英幸,英樹,英生,英暉,詠希,鋭気,央輝,央樹,絵一輝,笑生,榮規
えいじ	えいじ,エージ,叡司,叡思,叡治,叡二,映司,映士,映志,映治,映自,映馳,映二,栄司,栄士,栄志,栄至,栄児,栄次,栄治,栄爾,栄仁,栄地,栄智,栄二,栄路,永ニ,永意士,永維志,永司,永史,永嗣,永士,永志,永至,永児,永慈,永次,永滋,永治,永示,永仁,永知,永智,永二,永路,瑛維志,瑛司,瑛史,瑛嗣,瑛士,瑛志,瑛至,瑛詩,瑛児,瑛慈,瑛次,瑛樹,瑛心,瑛人,瑛仁,瑛智,瑛二,瑛路,英ニ,英司,英史,英嗣,英士,英志,英詩,英資,英侍,英児,英慈,英次,英治,英辞,英仁,英迅,英智,英二,英路,衛司,衛士,衛次,衛冶,詠司,詠嗣,詠士,詠志,詠慈,詠治,詠二,鋭司,鋭士,鋭児,鋭時,鋭治,鋭二,悦二,恵依侍,慧維志,江位司,江維次,哉司,哉志,哉仁,榮士,榮志,榮治,榮二
えいち	叡知,映智,永地,永智,瑛知,瑛智,英知,英地,英智,恵智
えいと	エイト,衣絃,叡音,叡采,叡人,叡杜,叡翔,映音,映士,映人,映仁,映斗,映杜,映登,映途,映都,映橙,映翔,曳永,曳斗,栄偉翔,栄一十,栄音,栄絃,栄虎,栄采,栄十,栄人,栄仁,栄生人,栄斗,栄杜,栄渡,栄登,栄都,栄冬,栄飛,栄豊,栄門,栄橙,栄翔,永愛,永依人,永遠,永乙,永音,永叶,永弦,永采,永士,永人,永仁,永尊,永跳,永兎,永斗,永杜,永渡,永登,永砥,永東,永桃,永透,永翔,泳人,泳斗,泳登,泳透,瑛,瑛愛,瑛依人,瑛依斗,瑛依翔,瑛維都,瑛衣翔,瑛壱斗,瑛永,瑛乙,瑛音,瑛叶,瑛弦,瑛絃,瑛虎,瑛采,瑛士,瑛糸,瑛時,瑛執,瑛疾,瑛十,瑛心,瑛人,瑛仁,瑛太,瑛大,瑛達,瑛跳,瑛堵,瑛徒,瑛斗,瑛杜,瑛渡,瑛登,瑛途,瑛都,瑛土,瑛冬,瑛燈,瑛統,瑛道,瑛任,瑛隼,瑛飛,瑛豊,瑛唯翔,瑛友,瑛利,瑛留,瑛和,瑛橙,瑛翔,英愛,英依人,英維翔,英衣斗,英一斗,英永,英叶,英弦,英絃,英虎,英采,英士,英十,英人,英仁,英征,英説,英達,英跳,英兎,英徒,英斗,英杜,英登,英都,英燈,英統,英道,英隼,英飛,英豊,英門,英利,英橙,英綸,英翔,衛十,衛人,衛仁,衛斗,衛登,詠音,詠叶,詠虎,詠采,詠士,詠十,詠人,詠仁,詠跳,詠斗,詠杜,詠登,詠都,詠飛,詠和,詠橙,詠翔,鋭士,鋭人,鋭斗,鋭杜,鋭翔,榎愛,央士,央仁,央斗,央登,央翔,絵衣人,恵偉人,恵絃,恵土,恵唯人,慧愛,慧偉斗,慧糸,哉叶,哉人,哉仁,哉斗,秀人,笑愛,笑依音,笑依翔,笑偉人,笑偉斗,笑偉翔,笑維人,笑維翔,笑絃,笑斗,八一,八斗,榮士,榮人,榮斗,榮杜,榮都,榮利,榮翔,衞人
えいる	栄琉,永留,瑛留,詠琉,笑琉,榮琉
おうが	逢牙,央河,央俄,央我,央芽,央賀,央雅,央駕,央翔,旺伽,旺河,旺芽,旺雅,旺駕,旺楽,欧雅,王河,王我,王牙,王芽,王賀,王雅,王駕,王月,王翔,黄雅,皇嘉,皇我,皇牙,皇雅,皇琥,皇翔,桜河,桜我,桜牙,桜臥,桜駕,桜海,桜虎,桜舞,桜翔,相鹿,多鹿,太翔,大河,大雅,大翔,鷹我,鷹臥,淡河,淡川,尾可,凰河,凰華,凰我,凰牙,凰芽,凰賀,凰雅,凰岳,凰叶,凰翔,應我,應雅,櫻華,櫻牙,櫻臥,櫻賀,櫻雅,櫻翔,煌河,煌我,煌牙,煌芽,煌賀,煌雅,煌駕,煌琥,煌翔
おうじ	央司,央児,央慈,央治,央二,旺司,旺嗣,旺士,旺志,旺児,旺慈,旺治,欧司,欧二,欧路,王子,王侍,王治,黄神,皇子,皇児,皇寺,桜強,桜司,桜士,桜時,桜次,凰司,凰慈,凰次,凰二,櫻司,鷗二
おうせい	逢成,逢星,逢晴,逢生,逢聖,逢惺,逢晟,央征,央成,央星,央晴,央清,央生,央盛,央聖,央誠,央青,央惺,央晟,旺世,旺成,旺星,旺晴,旺正,旺清,旺生,旺盛,旺聖,旺誠,旺請,旺青,旺斉,旺惺,旺晟,欧政,王成,王星,王聖,王誠,王惺,黄清,黄生,晃青,皇世,皇成,皇晴,皇生,皇聖,皇誠,皇惺,桜征,桜政,桜晴,桜生,桜聖,桜誠,桜靖,桜惺,桜晟,大成,大晴,大晟,鷹星,鷹生,鷹聖,鷹誠,鷹靖,鷹惺,凰世,凰成,凰星,凰晴,凰正,凰清一,凰生,凰聖,凰誠,凰惺,凰晟,應晴,晄成,晄星,櫻政,櫻晴,櫻誠,櫻惺,洸晴,煌世,煌征,煌成,煌政,煌星,煌生,煌誠,煌晟,鶯生,鷗晴
おうた	逢太,逢汰,逢大,央唄,央詩,央多,央太,央汰,央大,応太,応大,押太,旺詩,旺太,旺汰,旺泰,旺大,旺立,旺逞,欧太,欧汰,王太,黄太,黄汰,皇太,皇汰,皇大,桜多,桜太,桜汰,桜大,衆太,碩汰,扇太,扇大,大詩,鷹太,鷹大,隆詠,和蒔太,凰多,凰太,凰汰,凰泰,凰大,應太,應汰,應大,晄太,晄大,櫻太,櫻汰,櫻大,滉太,滉汰,煌太,煌汰,煌大
おうま	央真,央馬,央麻,央眞,旺真,旺馬,旺磨,旺茉,王真,王馬,翁馬,皇真,皇舞,皇磨,桜間,桜真,桜馬,桜麻,桜満,凰真,凰馬,凰實,櫻真,櫻摩,煌真,煌万,煌茉
おうら	央羅,旺羅,王羅,王嵐,皇羅,凰良,晄來,洸良
おおぞら	桜空
おさむ	おさむ,阿佐武,易,医,一,央佐武,央佐夢,央祥,王佐武,王佐夢,王才武,紀,京,経,乎祥,御,御佐武,御佐夢,功,攻,耕,宰,司,士,治虫,治牟,収,修,修向,修武,修務,修牟,秋,縮,小佐武,成,政牟,生佐武,生佐務,生佐夢,生佐無,生左務,生左夢,生左無,節,蔵,男佐武,男佐務,男佐夢,男佐無,男左務,男左無,致勲,長生,長武,長務,長夢,長無,長牟,長六,鎮,徹,統,敦,納,夫佐務,夫左務,夫左夢,夫左無,平,麻砂夢,孟夢,靖,雄佐武,雄佐務,雄佐夢,雄佐無,雄佐六,雄左務,雄左夢,雄祥,吏,理武,理夢,倫,和佐武,實,攝,收,脩
おと	愛斗,於十,於菟,於翔,央響,央人,央仁,央徒,央渡,央登,央途,央友,央翔,旺人,旺斗,王翔,乙斗,音士,音十,音人,音登,弦士,弦斗,弦杜,絃斗,渚人,渚斗,緒登,織登,生音,生人,大音,弟,百音,鳳都,麻采,麻杜,雄士,雄人,雄斗,雄翔,和斗,和途,和都,和翔,凰斗,凰杜,凰都
おとや	於菟弥,旺斗哉,乙哉,乙也,乙夜,乙弥,音哉,音谷,音也,音夜,音弥,音矢,音陽,音彌,響哉,響也,響夜,響矢,二矢
かい	海,亥,郁依,榎惟,榎椅,榎生,榎已,伽以,伽惟,佳,佳偉,佳威,佳惟,佳意,佳易,佳維,佳亥,佳一,佳壱,佳生,佳唯,加偉,加惟,加生,加唯,可葦,可以,可伊,可依,可偉,可威,可惟,可維,可緯,可一,可唯,嘉偉,嘉威,嘉意,嘉為,嘉維,嘉緯,嘉衣,嘉一,嘉五,嘉射,嘉生,嘉唯,嘉已,夏伊,夏偉,夏威,夏壱,夏生,夏唯,寡威,果一,果生,架委,架異,架生,歌威,歌衣,河依,河偉,河威,珂依,珂偉,珂惟,珂維,珂衣,珂生,禾偉,禾維,箇威,花威,花生,華維,華緯,華生,華唯,迦偉,賀伊,賀偉,賀維,賀一,駕偉,駕緯,介,解,回,塊,廻,快惟,快維,快生,戒,魁,魁壱,魁生,魁已,械,海伊,海偉,海夷,海威,海意,海維,海一,海生,海斐,海已,界,皆,芥,開,開唯,階,凱,浬,掛以,叶偉,叶惟,叶衣,叶亥,叶唯,樺一,樺生,幹偉,敢偉,駆威,駈威,圭威,香伊,采夷,賜,勝惟,日威,日生,桧,楓惟,楓彩,楓唯,風伊,風惟,風衣,風舞,風李,和維,和衣,檜,楷,櫂生,珈偉,珈衣,翔偉,翔威,翔惟,翔衣,翔一,翔功,翔生,翔聖,翔也,翔唯,諧,諧生
かいせい	海成,亥星,亥惺,佳正,佳生,佳聖,嘉斐誠,嘉比晴,夏衣生,介晴,介晟,快世,快凄,快征,快成,快政,快星,快正,快清,快生,快盛,快聖,快誓,快青,快惺,快晟,戒誠,改星,魁衣青,魁世,魁征,魁成,魁星,魁晴,魁正,魁生,魁聖,魁誠,魁惺,魁晟,海城,海世,海征,海成,海政,海星,海晴,海清,海生,海盛,海聖,海誠,海青,海斉,海靖,海惺,海晟,界世,界聖,皆成,皆生,皆惺,絵世,絵星,絵晴,開世,開成,開星,開晴,開正,開生,開聖,開誠,開惺,開晟,凱世,凱成,凱政,凱星,凱晴,凱正,凱生,凱聖,凱誠,凱惺,凱晟,鎧世,鎧聖,甲斐聖,合晟,桧星,桧清,桧生,桧聖,桧斉,檜生,楷成,楷生,楷聖,櫂世,櫂征,櫂成,櫂政,櫂星,櫂晴,櫂正,櫂生,櫂聖,櫂誠,櫂晟,翔星,諧世,諧征,諧成,諧生
かいと	海斗,海渡,かい斗,かい杜,榎絃,伽伊都,佳以采,佳伊人,佳依人,佳偉斗,佳弦,佳絃,佳虎,佳人,佳斗,佳登,佳斐斗,佳綸,佳翔,加依人,加衣斗,加衣翔,可以翔,可伊杜,可偉人,可偉斗,可威斗,可弦,可絃,嘉惟人,嘉弦,嘉絃,嘉純,夏伊斗,夏衣人,夏衣斗,夏絃,夏糸,夏綸,果偉人,果威翔,果維翔,架愛,架依翔,架偉斗,架絃,歌唯斗,河依翔,珂偉人,珂偉斗,禾衣人,禾衣仁,禾弦,禾絃,花伊人,花衣斗,花糸,華弦,華絃,華糸,迦依人,迦絃,賀威斗,賀意人,介音,介虎,介人,介斗,介杜,介渡,介登,介都,介翔,会仁,会登,会都,解斗,塊斗,塊土,廻人,廻仁,廻翔,快永,快音,快叶,快弦,快絃,快虎,快采,快士,快糸,快疾,快人,快仁,快説,快跳,快兎,快徒,快斗,快杜,快渡,快登,快途,快冬,快透,快篤,快隼,快飛,快富,快朋,快門,快利,快翔,恢采,恢人,恢斗,恢都,恢翔,懐人,懐斗,懐都,戒人,戒兎,戒斗,改斗,改都,改翔,魁音,魁叶,魁虎,魁士,魁人,魁仁,魁大,魁兎,魁徒,魁斗,魁杜,魁渡,魁登,魁都,魁土,魁桃,魁飛,魁翔,械斗,海愛,海偉飛,海威飛,海維人,海維翔,海一斗,海永,海音,海外,海叶,海兜,海弦,海虎,海采,海士,海時,海十,海真,海人,海仁,海図,海征,海聖,海説,海太,海大,海跳,海兎,海堵,海斗,海杜,海渡,海登,海都,海砥,海土,海冬,海東,海燈,海透,海瞳,海徳,海任,海飛,海百,海敏,海富,海歩,海訪,海豊,海夢,海門,海唯音,海友,海利,海論,海和,海橙,海綸,海翔,界虎,界士,界人,界土,界利,界翔,皆音,皆人,皆斗,皆翔,絵音,絵采,絵士,絵人,絵斗,絵登,絵都,絵豊,絵翔,芥斗,開音,開士,開人,開仁,開太,開跳,開斗,開杜,開渡,開登,開途,開都,開土,開等,開道,開飛,開冨,開翔,貝人,貝斗,貝都,凱音,凱叶,凱虎,凱士,凱十,凱人,凱仁,凱大,凱兎,凱斗,凱渡,凱登,凱都,凱土,凱冬,凱飛,凱豊,凱門,凱友,凱翔,鎧人,鎧斗,鎧任,鎧翔,浬都,叶偉人,叶弦,樺衣斗,敢偉斗,輝弦,峡斗,圭以仁,圭絃,圭生仁,甲斐人,甲斐斗,甲斐都,甲斐翔,香衣斗,香弦,蚕斗,秋音,神威斗,奏海,替戸,凧,日夷斗,桧采,桧士,桧人,桧存,桧斗,桧杜,桧都,桧土,桧飛,桧富,桧翔,楓絃,楓純,楓翔,魅音,魅大,魅斗,魅翔,耀弦,和弦,和絃,賄斗,檜人,檜斗,檜飛,楷十,楷人,楷斗,楷都,楷土,楷門,楷友,楷翔,櫂音,櫂叶,櫂采,櫂士,櫂人,櫂仁,櫂大,櫂斗,櫂杜,櫂渡,櫂登,櫂都,櫂冬,櫂利,櫂橙,櫂翔,翔一斗,翔絃,翔大,翔斗,諧士,諧人,諧斗,諧豊,諧翔
かいほ	快帆,海秀,海穂,絵穂,開歩,桧穂,櫂帆,櫂穂
かいや	快哉,快也,魁埜,魁也,魁夜,魁弥,海哉,海埜,海八,海冶,海弥,海矢,海陽,開哉,開也,開野,開矢,凱也,甲斐弥,届也,帆矢,和生弥,櫂哉,櫂也,櫂弥
かいら	亥良,快楽,快空,快羅,快良,恢良,改羅,魁良,海空,海嵐,海萊,甲斐良,櫂羅
かいり	葵陸,亥浬,佳衣梨,佳衣理,佳衣里,加衣理,可偉利,可偉李,嘉惟利,夏偉凛,夏維吏,夏衣吏,夏衣俐,夏唯理,花衣理,花衣里,迦偉理,介理,会浬,会利,会李,会里,会莉,塊吏,快浬,快哩,快利,快吏,快理,快琉,快涼,快玲,快俐,懐理,戒吏,戒李,戒凛,改理,魁浬,魁利,魁吏,魁李,魁理,魁璃,魁里,魁陸,魁劉,魁琉,魁稜,魁麗,魁俐,魁莉,海維吏,海光,海利,海吏,海裡,海律,海琉,海隆,海竜,海龍,海琳,海麟,海玲,海俐,海黎,灰里,界李,界理,界璃,界莉,皆吏,絵利,絵吏,開浬,開吏,開李,開理,開璃,開里,開琳,開莉,凱浬,凱利,凱吏,凱李,凱梨,凱理,凱璃,凱里,凱陸,凱麗,凱俐,凱凛,凱稟,凱莉,凱凜,鎧李,浬利,浬吏,浬李,叶偉里,叶一里,圭一吏,香衣里,桧浬,桧有,桧吏,桧理,桧里,桧琉,桧凛,桧稟,和依李,賄里,楷浬,楷利,櫂人,櫂入,櫂利,櫂吏,櫂李,櫂梨,櫂理,櫂璃,櫂里,櫂竜,櫂凛,櫂莉,翔偉凜,翔琉
かえで	叶楓,楓寧,楓木,夢葉,廣澤
かおる	一織,佳生流,佳生留,佳男流,佳夫流,佳夫留,佳雄流,佳雄留,加緒流,加緒瑠,加生流,加生留,加男流,加男留,加百琉,加百留,加夫流,加夫留,加穂流,加穂留,加雄流,加雄留,可生流,可男流,可男留,可夫流,嘉流,嘉留,夏生流,夏生留,夏男流,夏男留,夏風,夏雄流,夏雄留,寡流,寡留,果織,花生流,花生留,花男流,花男留,花夫流,花夫留,花雄流,花雄留,馨織,馨流,馨留,顔流,顔留,薫,香央琉,香緒里,香生流,香生留,香折,香男流,香夫流,香夫留,香保里,香雄流,香雄留,香里,日織,菩,和織,翔織,翔穂流
かおん	夏臣,果恩,嘩音,叶恩,奏穏,翔音
かがり	華々莉,利理
かぐら	夏蔵,花蔵,華蔵
かける	一翔,伽翔,佳蹴,加啓琉,加啓留,加圭流,加慶流,加慶留,加敬琉,加敬瑠,可啓留,嘉花琉,夏啓琉,夏啓留,夏圭留,夏敬流,夏敬留,夏蹴,夏翔,架,架流,架瑠,河啓琉,河啓留,花圭琉,掛流,掛留,掛瑠,駆流,駆琉,駆留,駆瑠,駆塁,駈,駈流,駈琉,駈瑠,空,懸,懸希琉,駿,駿来,走,賭,飛,翼,和蹴,翔海,翔懸琉,翔大,翔風,翔夢,翔流,翔留,翔隆,翔瑠,翔塁,颯
かざほ	風宝
かすが	佳清
かず	カズ,壱,嘉,嘉津,圭寿,憲,航,数,千,知,雄,良,和寿,和周,和都
かずあき	一瑛,一暁,一顕,一光,一晃,一秋,一彰,一昭,一晶,一焼,一誠,一壮,一哲,一彬,一明,一曜,一陽,一諒,壱旺,佳瑞秋,算朗,司尭,司誠,主晟,寿英,寿彰,寿招,千照,千明,雄章,和亜樹,和映,和暁,和顕,和昂,和晃,和秋,和彰,和招,和晶,和章,和誠,和哲,和明,和陽,和亮,和諒,和朗
かずい	一維,一勇,嘉瑞,和依,和維,和已
かずお	かずお,一央,一緒,一生,一男,一夫,一雄,一郎,員生,員男,員夫,員雄,伽寿生,加寿夫,嘉寿男,嘉寿夫,嘉寿雄,稼頭央,計生,計男,計夫,計雄,三郎,七生,寿雄,順雄,数生,数大,数男,数夫,数雄,千男,千雄,弐夫,万雄,量大,和央,和王,和巨,和生,和壮,和男,和尾,和夫,和穂,和雄,和郎
かずき	一葵,一器,一基,一岐,一揮,一期,一機,一毅,一規,一記,一起,一軌,一輝,一騎,一亀,一桔,一決,一己,一城,一生,一来,一燿,一絆,一翔,一驥,一麒,壱基,壱祈,壱輝,壱騎,壱樹,壱奎,壱綺,員生,胤輝,胤樹,胤熙,円基,円希,円規,佳樹,佳須輝,佳瑞貴,加寿己,嘉須季,夏寿紀,夏壽樹,賀寿樹,紀生,起揮,九希,計生,憲輝,航喜,航希,航紀,航輝,航樹,航生,航来,航來,航熙,三貴,三樹,司揮,司稀,主基,主季,主貴,主輝,主樹,寿希,寿祈,寿紀,寿輝,寿騎,寿樹,十希,十季,十紀,十貴,十輝,十樹,重季,重紀,重貴,重輝,重樹,春輝,春樹,数喜,数希,数紀,数規,数貴,数起,数輝,数己,数樹,数生,数礎,数来,政希,千葵,千喜,千希,千祈,千季,千紀,千貴,千起,千輝,千亀,千慶,千樹,千暉,多輝,知希,知輝,知樹,知生,百樹,法生,睦希,万希,万貴,万樹,嵐生,蘭寿利,利基,和基,和揮,和旗,和毅,和気,和祈,和規,和起,和軌,和騎,和亀,和祁,和己,和城,和其,和大,和津希,和槻,和来,和林,和來,和暉,和煌,和絆,和綺,和麒
かずさ	一冴,一爽,一総,胤冴,司倖,寿佐,寿瑳,寿裟,寿作,上総,千冴,千智,知冴,和慧,和倖,和冴,和真,和総,和聡
かずね	一寿音,壱音,円音,加杜音,紀音,兼音,憲音,研音,航音,克寿音,三音,司音,七音,主音,寿音,宗音,十音,順音,勝音,政音,多音,知音,二音,八音,雄音,良音,麗音,倭音,和直,和祢,和峰
かずは	一秦,一颯,一遙,佳津巴,寿生,寿覇,千蓮,冬羽,万棄,煌月羽
かずほ	一寿穂,一甫,壱宝,航帆,寿保,寿甫,寿輔,寿芳,宗穂,千宝,知歩,良帆,和甫,和宝,和芳,和誉,和穗
かずま	一護,一実,一守,一寿馬,一勝,一真,一馬,一舞,一摩,一磨,一麻,一槙,一麿,一万,一満,一優,一眞,一翔,一茉,一萬,壱真,壱馬,壱磨,壱茉,胤真,胤馬,佳主馬,佳寿真,加治眞,加寿実,夏主馬,霞真,葛馬,紀真,紀摩,教真,圭津麻,兼末,航真,克優,三真,三馬,三万,司真,司馬,司磨,司眞,主守,主真,主馬,主磨,主麻,主眞,寿真,寿馬,寿麻,寿満,宗真,宗馬,十満,順真,順麻,数間,数実,数真,数馬,数摩,数磨,数麻,数満,数詢,籍真,千慎,千真,千誠,千馬,千摩,千磨,千麻,千眞,知真,知摩,知磨,知眞,二真,二馬,二万,二茉,百真,法麻,万真,蘭寿磨,利真,利磨,良守,良真,良馬,良磨,麗磨,倭満,和雅,和間,和実,和守,和真,和誠,和馬,和摩,和磨,和麻,和万,和満,和眞,和茉
かずみ	一益,一角,一己,一御,一光,一三,一省,一真,一身,一清,一積,一泉,一瞳,一二三,一麦,一味,一巳,一民,一已,壱海,佳珠美,佳瑞巳,佳積,佳津美,佳美,佳壽美,加壽美,可寿美,可積,嘉純,嘉図見,嘉澄,嘉津美,嘉美,果樹実,架清,禾積,雅寿美,計実,計美,香清,香津美,三省,鹿角,鹿住,主海,寿実,勝住,勝巳,昭美,数見,数三,数実,数身,数味,数巳,千海,千未,鶴見,八海,毎実,毎美,夢実,利美,良美,量美,量未,和位,和己,和司,和充,和親,和身,和瑞,和相,和文,和望,和巳,和命,和良,和已
かずや	一哉,一八,一冶,一耶,一弥,一矢,一優,一陽,一彌,一椰,壱哉,壱也,壱弥,員哉,胤也,佳主也,佳寿也,佳洲也,佳須也,佳瑞也,加寿哉,加寿也,歌寿哉,賀津也,馨寿也,紀陽,九也,九弥,九矢,計也,兼也,憲哉,憲弥,航也,司弥,七弥,主也,主弥,寿也,寿弥,宗也,十也,十弥,十矢,重哉,重也,順哉,順也,順弥,順矢,数哉,数八,数也,数弥,数矢,千哉,千也,千耶,千弥,千矢,千椰,知也,知弥,年哉,百也,風弥,睦哉,睦也,睦弥,睦矢,万也,量也,量矢,和哉,和八,和巳,和也,和冶,和夜,和耶,和弥,和矢,和彌,和椰
かずよし	かずよし,一佳,一嘉,一喜,一義,一吉,一圭,一賢,一功,一好,一剛,一至,一世氏,一善,一代氏,一禎,一美,一福,一芳,一由,一良,員仁,円理,加治良,紀賀,紀凱,紀祥,計佳,計吉,司佳,七嘉,寿佳,宗義,春賀,数義,千源,千善,多允,多可,知慶,知良,万義,利賀,和愛,和佳,和嘉,和喜,和義,和吉,和恭,和慶,和好,和治,和淑,和祥,和世志,和世氏,和成,和整,和善,和泰,和代氏,和禎,和能,和美,和芳,和由,和誉,和良
かつき	佳津樹,佳槻,加月,夏槻,迦月,賀月,海月,活希,活輝,活樹,活来,且己,椛月,健希,豪起,克葵,克牙,克基,克希,克毅,克季,克紀,克記,克貴,克起,克輝,克騎,克月,克己,克樹,克生,克熙,勝喜,勝基,勝希,勝毅,勝紀,勝規,勝記,勝貴,勝輝,勝騎,勝月,勝樹,勝城,勝生,勝暉,優希,優輝,稜月,翔月
かつひろ	一博,賀津宏,活裕,且丈,功宗,功博,克央,克寛,克宏,克広,克弘,克浩,克尋,克泰,克大,克拓,克博,克祐,克裕,克洋,勝寛,勝啓,勝宏,勝広,勝弘,勝浩,勝大,勝博,勝裕,勝洋
かつみ	かつみ,嘉津美,活美,活巳,葛三,葛実,葛美,桂美,賢心,克,克海,克心,克望,克巳,克弥,克已,克躬,勝看,勝己,勝充,勝心,勝身,勝巳
かつら	香都良
かづき	一記,一月,一樹,佳槻,果都生,珂月,禾月,柑月,克樹,勝月,神月,蘭月,和基,和輝,翔月
かなう	一那宇,華和羽,哉優,奏,奏祐,奏夢,奏優
かなた	カナタ,愛建,愛太,愛汰,愛大,一七太,一七汰,一七大,一那樹,一那汰,一凪太,一凪汰,一名太,宇宙,榎凪太,伽那汰,佳菜太,佳奈太,佳那太,佳那汰,佳那大,佳名太,佳名汰,佳和太,佳梛太,加菜太,加菜汰,加七太,加奈太,加那太,可向,可奈多,可南多,可南太,可南汰,嘉向,嘉成汰,嘉奈多,嘉奈太,嘉凪多,嘉南汰,嘉波多,夏向,夏菜太,夏渚太,夏奈太,夏那太,夏那汰,夏那大,夏凪多,夏凪太,夏凪汰,夏南汰,夏南大,架向,架凪舵,歌菜太,歌那多,花菜太,花奈太,花那太,華奈汰,賀奈太,海音,海七太,海那汰,海凪太,海南太,海梛太,馨向,楽汰,叶,叶貴,叶起,叶建,叶高,叶詩,叶七大,叶種,叶樹,叶匠,叶植,叶炊,叶嵩,叶太,叶汰,叶唾,叶舵,叶駄,叶泰,叶大,叶達,叶竪,叶那太,叶南太,叶名大,叶立,叶隆,叶竜,叶逞,樺堵,協多,協太,協汰,協泰,協長,金多,金太,金汰,金谷,金田哲,金武,圭凪太,乎樹,香菜太,香奈太,香那太,哉詩,哉樹,哉匠,哉丈,哉瑞,哉太,哉汰,哉泰,哉大,哉那多,哉竜,称大,称逞,心葵,心湊,川鳴太,奏,奏音,奏歌,奏海,奏堪,奏貴,奏建,奏巧,奏詩,奏手,奏樹,奏丈,奏瑞,奏尊,奏太,奏妥,奏舵,奏陀,奏泰,奏大,奏長,奏佑,奏陽,奏樂,奏逞,大空,適太,天空,日七太,桧七太,風夏汰,未来,優空,悠,要多,要太,要汰,要大,遥,遼,和菜汰,和七太,和那太,翔向,翔奏,翔太,翔那多,翔那太,翔那汰,翔湊
かなで	叶弟,湊,翔名出
かなと	愛士,愛十,愛堵,愛斗,愛都,愛透,愛友,愛翔,榎南人,伽那斗,佳奈人,佳奈斗,佳奈登,佳名斗,佳名都,加菜斗,加奈斗,加那斗,加那都,加那翔,加名人,可那斗,可那翔,可南斗,嘉奈人,嘉和士,夏菜斗,夏七翔,夏渚登,夏那翔,夏凪人,夏凪翔,夏南斗,夏南翔,夏湊,果奈人,果奈斗,歌那冬,華菜斗,華成人,華那叶,華那斗,華那翔,海永斗,海夏人,海夏斗,海那斗,海凪斗,海南人,海南斗,海波斗,海梛斗,叶,叶遠,叶乙,叶虎,叶采,叶士,叶十,叶仁,叶説,叶達,叶兎,叶堵,叶斗,叶杜,叶渡,叶登,叶途,叶都,叶冬,叶燈,叶透,叶那士,叶那斗,叶那翔,叶富,叶夢,叶友,叶来翔,叶利,叶橙,協人,協斗,協飛,金飛,交奈斗,香奈兎,香奈斗,香奈登,哉音,哉叶,哉采,哉士,哉人,哉仁,哉兎,哉斗,哉杜,哉渡,哉登,哉都,哉努,哉年,哉朋,哉橙,神奈都,枢門,奏遠,奏共,奏絃,奏戸,奏采,奏士,奏心,奏人,奏仁,奏聡,奏達,奏杜,奏登,奏途,奏都,奏土,奏冬,奏灯,奏燈,奏当,奏透,奏堂,奏年,奏飛,奏富,奏門,奏友,奏利,奏和,奏橙,泰人,要采,要人,要斗,要登,要都,要砥,要翔,翔斗,諧采
かなむ	可成夢,叶奈夢,叶武,叶舞,叶睦,奏武,奏舞,奏六
かなめ	加南芽,夏菜芽,火奈芽,叶人,叶馬,協愛,哉芽,哉馬,奏恩,奏恵,奏成芽,奏馬,奏明,奏要,奏惠,泰明,彼芽,要人,領,和生芽,翔夏命,翔命
かなる	嘉成,夏成,夏南留,果成,果也,芽生,叶成,叶留,叶瑠,哉成,哉琉,奏,奏琉,翔成,翔成琉,翔生
かむい	カムイ,加夢意,可夢偉,嘉武伊,雅夢偉,叶夢,叶夢偉,叶夢唯,冠偉,冠意,冠衣,冠唯,香六,神威岬,神維,神衣,神居,勇侍,翔武威,翔夢偉,翔要
かん	寬,乾,侃,冠,勧,完,寛,歓,漢,緩,艦,莞,観,貫,還,鑑,閑,紺,菅,函,奐
きいち	葵依智,葵壱,葵市,黄一,伎壱,喜以知,喜伊知,喜位置,喜依智,喜一,喜壱,喜逸,喜市,喜都,基惟千,基一,基壱,基都,基唯千,嬉一,希以智,希伊千,希維千,希一,希壱,希市,棋市,機一,機壱,機市,帰一,毅一,季偉知,季意知,季一,季市,稀一,稀壱,稀市,紀伊千,紀伊智,紀一,紀壱,紀市,紀千,紀智,規惟千,規一,規壱,規市,規唯千,記一,記壱,記市,貴一,貴壱,貴市,起一,起壱,軌一,輝偉知,輝一,輝壱,輝逸,輝市,騎一,騎逸,鬼一,亀惟千,亀市,亀唯千,桔一,桔壱,桔市,己一,樹一,樹壱,樹市,生一,聴一,槻一,木一,木壱,木市,來一,揆一,暉一,杞一,絆一,絆壱,綺一,麒一,麒壱,熙一
きお	葵生,幹央,喜生,喜大,喜夫,基雄,希音,季大,稀央,稀大,稀凰,紀央,貴生,起穂,軌央,輝於,輝乙,輝男,祁士,樹央,樹音,樹桜,妃桜,來旺,暉生,綺青
きおり	基織
きずき	喜寿輝,希寿輝,城,築輝,絆喜,絆來,絆煌
きずな	気沙,貴砂,絆成
きせき	喜星輝,喜積,希釈,希世希,希世稀,希世貴,希世綺,希星輝,希隻,希拓,祈跡,稀世希,稀世稀,稀世貴,稀世綺,貴汐,貴世希,貴世稀,貴世貴,貴世綺,貴石,輝跡,煌成樹,煌星輝,煌隻,綺世希,綺世稀,綺世貴,綺世綺
きづき	基就,奇月,紀月,貴月,樹月
きなり	葵哉,葵成,葵晴,葵也,喜成,喜也,希哉,貴成,貴也,起成,桔生,桔礼,樹成,木也,熙哉
きはる	葵春,乙晴,幹治,喜晴,喜遥,喜陽,希桜,季治,季明,季悠,季遥,稀春,稀晴,紀晴,貴遥,貴陽,輝啓,輝桜,輝春,輝晴,輝明,輝陽,吉玄,桔大,樹治,樹春,樹晴,樹暖,来晴,暉悠,煌晴,絆晴
きひろ	葵大,喜啓,喜紘,喜尋,喜優,基宙,希啓,希光,希洋,希昊,毅宏,季宏,季優,稀弘,稀優,紀宏,貴尋,貴優,貴祐,輝広,輝浩,輝紘,輝大,輝洋,樹裕,来広
きょう	葵陽,希燿,稀陽,巨宇,京優,競,協,卿,強,恭生,経,孝,耕
きょうま	叶真,叶誠,叶馬,叶眞,亨馬,京真,京馬,京摩,京磨,京麻,侠磨,協真,協磨,匡真,匡眞,恭馬,恭摩,恭磨,恭麻,興真,鏡真,鏡馬,響真,響馬,響磨,経磨,今日磨,俠真
きよし	きよし,葵介,喜佳,喜義,喜好,喜資,喜淑,喜代司,喜代子,喜代志,喜芳,喜由,喜与士,喜与志,喜誉志,喜良,基代志,奇世司,寄与志,寄良,岐依志,岐世史,岐世士,岐与志,希佳,希義,希吉,希世史,希世始,希世志,希世祉,希世詩,希代士,希代志,希与資,希誉士,希誉志,希葉始,希葉志,希葉祉,希葉詩,希良,幾世志,機吉,機与志,機良,気賀,季吉,季祥,季良,稀佳,稀吉,稀世志,稀世祉,稀世詩,稀誉士,稀誉志,稀良,紀喜,紀義,紀吉,紀治,紀世志,紀代史,紀由,紀与士,紀誉資,紀良,規世司,規予志,規良,記代士,記代志,記美,記良,貴依志,貴佳,貴義,貴吉,貴世司,貴世史,貴世始,貴世志,貴世祉,貴世詩,貴世資,貴代嗣,貴代志,貴由,貴余資,貴与至,貴葉志,起世志,起余資,起誉詞,起良,輝依史,輝喜,輝義,輝吉,輝欣,輝世史,輝世士,輝成,輝代史,輝代視,輝由,輝予志,輝与司,輝誉司,輝誉士,輝誉志,輝誉資,輝良,亀世志,亀世思,亀誉司,亀良,金良,屑,圭,圭志,潔,潔司,潔史,潔姿,潔至,潔視,潔詩,健,健志,己世志,己良,汐志,樹佳,樹可,樹義,樹吉,樹世始,樹世志,樹世祉,樹世詩,樹代志,樹芳,樹与志,樹誉志,樹良,粛司,粛史,粛志,淳志,城世志,浄,浄司,浄志,浄思,浄詩,澄,澄司,澄史,澄士,澄師,澄志,澄思,澄詞,澄詩,晴,清,清司,清史,清嗣,清士,清姿,清子,清師,清志,清思,清枝,清獅,清祉,清私,清紫,清至,清詞,清詩,清誌,清資,清次,清治,清示,清信,清心,清新,清真,清知,清椎,清之,聖,聖司,聖史,聖嗣,聖士,聖始,聖姿,聖志,聖思,聖祉,聖紫,聖至,聖視,聖詞,聖詩,聖誌,聖資,太花世詩,忠,白,木吉,木与志,木良,来吉,来世志,来良,廉,毀吉,毀良,暉与祉,氣代志,淨司,淨史,淨志,綺佳,綺世始,綺世志,綺世祉,綺世詩,綺予姿,綺良
きらり	稀星,貴星,金銀,樹来利,星願,星理,煌栞,綺羅人
きらん	輝蘭,樹藍,煌夢,綺藍
きり	葵俐,喜李,喜璃,喜麗,希俐,揮利,揮吏,揮李,揮俐,機利,季利,季吏,稀利,稀吏,稀璃,稀琳,規利,貴利,軌吏,輝利,輝理,輝離,鬼莉,己理,己里,霧,来里
きりあ	騎利亜,桐阿,桐上
きりん	記凜,貴琳,貴凛,輝凛
きるあ	喜瑠亜,希琉亜,希琉愛,希琉雅,希瑠歩,機離亜,輝流愛,輝琉愛,輝琉空
きわ	輝羽,生和
ぎん	ギン,吟,如
ぎんが	吟華,吟芽,吟賀,吟雅,銀華,銀俄,銀我,銀牙,銀芽,銀賀,銀雅,銀駕,銀月
くう	玖宇,玖佑,駈宇,空風,空夢,紅空,来侑,琥羽,琥佑,琥侑
くうが	空河,空珂,空俄,空峨,空我,空牙,空芽,空駕,空輝,空虎,空夢,空翔,徠駕
くうや	玖羽弥,玖恭,空八,空也,空冶,空夜,空耶,空野,空弥,空矢,空彌,空椰,功弥
くおん	久恩,久温,九遠,九穏,玖恩,玖温,駆音,空穏,公遠,来恩,来音,來恩,琥園,琥遠
くるみ	玖琉海
けい	Ｋ,希偉,希惟,京唯,競,卿,係,刑,兄,啓偉,啓威,啓生,啓唯,圭偉,圭一,圭壱,径生,慶偉,慶唯,慧葵,携,敬威,敬唯,系,経,計,鶏,結,健衣,多嘉良,彗,繫
けいき	馨喜,馨樹,啓喜,啓貴,啓輝,啓樹,圭喜,圭希,圭紀,圭記,圭輝,圭樹,恵希,恵生,慶喜,慶貴,慶軌,慶輝,慧基,慧樹,慧綺,敬喜,敬基,敬記,敬貴,敬樹,景樹,景麒,桂葵,桂喜,桂基,桂紀,桂規,桂記,桂貴,桂輝,桂騎,桂己,桂樹,桂生,継貴,蛍幸,奎騎,繫喜
けいし	けい志,佳史,佳士,佳志,馨史,馨士,馨志,稀一子,稀唯子,京子,京志,京紫,京詩,啓司,啓史,啓嗣,啓士,啓子,啓志,啓思,啓詞,啓示,啓信,啓之,圭一士,圭司,圭史,圭嗣,圭士,圭子,圭志,圭思,圭至,圭治,圭信,圭知,圭之,圭唯士,珪史,恵沙,恵仕,恵司,恵史,恵嗣,恵士,恵志,恵施,恵詞,恵信,慶司,慶史,慶嗣,慶士,慶子,慶志,慶思,慶施,慶至,慶詞,慶詩,慧司,慧史,慧士,慧志,慧思,慧詩,慧之,敬沙,敬司,敬史,敬士,敬子,敬志,敬至,敬視,敬詩,敬信,敬之,景士,景子,景思,景視,景偲,景信,桂史,桂士,桂信,渓子,渓信,継志,蛍司,蛍志,結志,堅石,光史,酒井,肇史,彗司,惠志,繫至
けいしゅん	啓俊,圭俊,圭春,恵俊,慶俊,慶瞬,慶駿,慶純,慶隼,慧俊,景春,渓旬
けいじ	けい士,佳司,佳嗣,佳士,佳児,佳慈,佳仁,佳二,馨詩,馨慈,京祇,京司,京至,京治,刑事,刑児,刑次,刑治,刑二,刑路,兄児,兄次,兄治,兄二,兄路,啓司,啓史,啓嗣,啓士,啓志,啓至,啓詞,啓資,啓児,啓慈,啓次,啓治,啓爾,啓示,啓仁,啓地,啓二,啓之,啓路,圭司,圭史,圭士,圭志,圭至,圭児,圭慈,圭時,圭次,圭治,圭示,圭二,圭之,圭路,恵ニ,恵司,恵史,恵嗣,恵師,恵詩,恵侍,恵児,恵慈,恵次,恵治,恵辞,恵二,恵巳,恵路,慶ニ,慶義,慶司,慶史,慶士,慶志,慶侍,慶児,慶慈,慶次,慶治,慶寿,慶臣,慶仁,慶二,慶路,慧司,慧次,慧治,慧示,慧二,敬司,敬史,敬士,敬志,敬詩,敬慈,敬次,敬治,敬仁,敬二,敬路,景ニ,景司,景史,景士,景児,景次,景治,景仁,景二,景路,桂司,桂史,桂士,桂児,桂慈,桂次,桂滋,桂治,桂示,桂二,桂路,渓史,渓志,渓次,系児,系次,系治,系二,系路,経司,経示,蛍士,蛍慈,蛍治,蛍二,計児,計次,計治,計二,計路,鶏二,勁次,勁治,勁二,奎司,奎治,奎二,惠司,惠滋,惠治,惠二
けいじゅ	佳樹,啓寿,啓樹,圭珠,圭寿,圭樹,恵鷲,慶寿,慶樹,慧珠,慧寿,慧樹,慧鷲,敬樹,景樹,蛍寿,結珠,結寿,諒樹,奎樹
けいと	佳永,佳弦,佳人,佳智,佳跳,佳斗,佳登,佳土,佳飛,佳利,佳翔,馨人,馨大,馨斗,希維人,希弦,希絃,希生仁,京人,京跳,京斗,京翔,卿人,卿斗,兄斗,啓音,啓叶,啓戸,啓采,啓士,啓十,啓人,啓仁,啓征,啓聡,啓大,啓跳,啓斗,啓杜,啓統,啓豊,啓利,啓翔,圭衣翔,圭叶,圭桐,圭弦,圭虎,圭采,圭糸,圭人,圭仁,圭説,圭斗,圭杜,圭渡,圭土,圭冬,圭飛,圭利,圭綸,圭翔,契人,恵永,恵士,恵仁,恵澄,恵徒,恵土,恵燈,恵飛,恵豊,恵橙,恵遙,慶乙,慶戸,慶虎,慶士,慶十,慶人,慶仁,慶杜,慶祷,慶透,慶敏,慶豊,慶門,慶橙,慶翔,慧叶,慧弦,慧絃,慧士,慧人,慧仁,慧大,慧杜,慧登,慧土,慧冬,慧燈,慧敏,慧門,憩人,憩仁,憩斗,敬依斗,敬音,敬士,敬人,敬仁,敬大,敬斗,敬土,敬冬,敬富,敬豊,敬翔,景虎,景士,景人,景杜,景渡,景翔,桂士,桂人,桂斗,桂渡,桂登,桂冬,渓桐,渓人,渓斗,渓登,系都,継人,継斗,継渡,継登,継都,繋人,蛍弦,蛍人,蛍仁,詣人,鯨人,結人,結仁,結都,結冬,結門,結友,結翔,勁人,奎人,奎斗,奎都,彗人,彗斗,彗杜,彗都,彗翔,惠虎,惠士,惠人,惠仁,惠斗,惠登,惠都,惠翔,憬音,繫人,繫仁,繫斗
けいや	佳弥,佳矢,馨也,京哉,京也,京弥,啓哉,啓也,啓弥,啓矢,圭哉,圭也,圭耶,圭弥,圭矢,径也,恵哉,恵也,恵弥,恵矢,慶,慶哉,慶也,慶耶,慶弥,慶矢,慧哉,慧也,慧弥,慧矢,敬哉,敬也,敬弥,景也,景弥,景彌,桂哉,桂也,桂弥,桂矢,渓也,継也,奎哉,奎也,奎弥
けいん	ケイン,佳音,華音,快音,圭音,恵韻,恵音,景音,渓允,計韻,計音
けん	けん,ケン,絢,嘉武,花武,乾,監,希武,稀武,件,倹,兼,券,剣,圏,堅,建,憲,懸,拳,検,権,献,研,絹,県,見,謙,賢,軒,遣,鍵,険,顕,験,玄,圈,栞,縣,虔,顯
こあ	呼亜,湖有,虎光,瑚逢,孝亜,来空,琥羽,琥吾,琥充,琥天
こう	輝,輝歌,亨,匡,興,仰,空,茎,己宇,己優,湖,湖宇,湖友,胡,虎,虎宇,虎羽,虎於,虎佑,虎優,誇生,誇有,瑚宇,瑚生,瑚優,侯,光生,光優,功,効,厚,后,孔,孝,孝宇,孝羽,工,巧,幸雨,幸生,弘,抗,攻,晃,晃生,更,校,梗,構,洪,浩,港,皇宇,皇王,稿,耕,考,航生,行,衡,講,貢,鋼,閤,降,項,高,剛,轟,冴生,冴優,子空,縞,心羽,心優,心侑,虹空,虹植,来於,来侑,亘,廣,昊生,昊洸,昴,煌羽,琥宇,琥海,琥生,琥佑,琥優,琥有,皓
こうき	こう希,黄輝,輝希,輝毅,輝騎,輝生,亨希,亨規,亨樹,匡希,匡毅,匡玖,興喜,興基,興希,興毅,興季,興稀,興紀,興貴,興起,興輝,興騎,興碁,興暉,仰輝,空葵,空希,空祈,空季,空貴,空輝,空樹,空生,空暉,虎貴,虎輝,誇希,侯来,倖葵,倖幹,倖喜,倖基,倖希,倖毅,倖季,倖稀,倖紀,倖規,倖貴,倖輝,倖己,倖樹,倖城,倖来,倖暉,倖絆,光葵,光幹,光伎,光喜,光基,光嬉,光揮,光棋,光毅,光気,光祈,光季,光稀,光規,光記,光貴,光起,光軌,光輝,光騎,光桔,光己,光碁,光哉,光樹,光粋,光生,光礎,光来,光來,光暉,光綺,光熙,公喜,公基,公希,公旗,公毅,公紀,公規,公記,公貴,公軌,公輝,公騎,公玖,公己,公樹,公煕,功喜,功基,功希,功揮,功気,功季,功稀,功紀,功規,功記,功貴,功起,功輝,功騎,功己,功樹,功礎,功暉,功絆,厚希,厚毅,厚輝,向葵,向喜,向希,向季,向輝,向樹,向来,后喜,后基,后希,后棋,后毅,后祈,后季,后稀,后紀,后貴,后碁,好喜,好嬉,好希,好機,好稀,好輝,好樹,好姫,好暉,孔基,孔紀,孔規,孔貴,孔輝,孔樹,孝葵,孝喜,孝基,孝岐,孝希,孝揮,孝毅,孝祈,孝季,孝稀,孝紀,孝規,孝貴,孝輝,孝騎,孝宜,孝己,孝樹,孝城,孝生,孝暉,孝煌,孝麒,宏喜,宏基,宏希,宏毅,宏季,宏紀,宏起,宏軌,宏輝,宏哉,宏樹,宏碧,工喜,工揮,工毅,工祈,工季,工紀,工貴,工輝,工騎,工碁,工暉,巧喜,巧基,巧希,巧揮,巧棋,巧毅,巧季,巧稀,巧規,巧貴,巧起,巧輝,巧宜,巧樹,幸き,幸葵,幸叶,幸喜,幸毅,幸気,幸祈,幸季,幸稀,幸紀,幸規,幸記,幸貴,幸起,幸輝,幸騎,幸亀,幸吉,幸決,幸己,幸幸,幸哉,幸樹,幸城,幸生,幸妃,幸来,幸暉,幸絆,幸綺,広喜,広基,広希,広毅,広季,広稀,広規,広貴,広輝,広騎,広興,広樹,庚希,康葵,康幹,康喜,康基,康岐,康希,康揮,康毅,康気,康季,康稀,康紀,康貴,康起,康輝,康騎,康亀,康己,康公,康幸,康樹,康城,康生,康暉,康熙,弘葵,弘幹,弘喜,弘基,弘希,弘毅,弘季,弘稀,弘紀,弘徽,弘規,弘貴,弘起,弘輝,弘騎,弘橘,弘己,弘樹,弘生,弘暉,弘煌,恒伎,恒喜,恒基,恒希,恒毅,恒季,恒稀,恒紀,恒貴,恒輝,恒樹,恒生,恒暉,攻輝,昂季,昂稀,昂紀,昂貴,昂起,昂軌,昂輝,昂己,昂樹,昂生,昂槻,昂来,昂暉,昂絆,昂熙,晃葵,晃魁,晃幹,晃喜,晃基,晃希,晃旗,晃毅,晃気,晃季,晃稀,晃紀,晃規,晃貴,晃起,晃軌,晃輝,晃己,晃樹,晃生,晃来,晃來,晃暉,晃煌,晃綺,更樹,梗希,江貴,江生,洪輝,浩喜,浩基,浩希,浩毅,浩紀,浩貴,浩輝,浩己,浩樹,浩生,浩暉,港希,甲基,甲輝,皇喜,皇基,皇希,皇揮,皇棋,皇毅,皇祈,皇季,皇稀,皇紀,皇規,皇貴,皇騎,皇碁,皇樹,皇暉,紅葵,紅季,紅輝,紘海,紘伎,紘喜,紘基,紘希,紘毅,紘祈,紘季,紘稀,紘紀,紘貴,紘起,紘騎,紘己,紘樹,紘城,紘生,紘来,紘暉,綱希,綱旗,綱紀,綱貴,耕希,耕季,耕貴,耕起,耕輝,耕己,耕樹,耕生,考基,考希,考毅,考記,考貴,考軌,考輝,考樹,航葵,航企,航伎,航喜,航基,航岐,航希,航揮,航旗,航毅,航気,航祈,航季,航稀,航紀,航規,航貴,航軌,航輝,航騎,航己,航行,航樹,航生,航来,航來,航絆,航綺,行輝,衡貴,貢基,貢生,鉱喜,鉱器,鉱希,鉱機,鉱稀,鉱貴,鉱起,鉱樹,鉱生,鉱綺,鋼希,鋼毅,鋼輝,項輝,香黄,香喜,香希,香紀,香貴,香輝,香生,高岐,高希,高季,高貴,高輝,高金,高樹,高暉,鴻希,鴻輝,鴻樹,鴻有喜,剛基,剛季,剛貴,剛輝,剛樹,剛生,剛暉,豪基,豪規,豪輝,豪騎,豪絆,皐葵,皐幹,皐希,皐季,皐稀,皐紀,皐貴,皐樹,皐生,皐暉,嵩喜,嵩希,嵩季,聖輝,筒井,虹葵,虹喜,虹希,虹気,虹季,虹稀,虹紀,虹貴,虹輝,虹樹,虹生,虹絆,虹熙,幌葵,幌希,幌輝,幌樹,岬樹,岬生,岬來,亘希,亘稀,亘紀,亘輝,亘桔,亘己,亘樹,亘生,亘暉,凰希,凰揮,凰紀,凰貴,凰輝,凰己,凰樹,凰生,凰暉,凰煌,廣稀,昊葵,昊伎,昊希,昊揮,昊毅,昊気,昊祈,昊季,昊稀,昊紀,昊貴,昊軌,昊騎,昊祇,昊己,昊幸,昊樹,昊生,昊来,昊來,昊暉,昴希,昴樹,晄幹,晄喜,晄希,晄気,晄稀,晄紀,晄輝,晄己,晄樹,晄生,晄大,晄暉,洸葵,洸乙,洸伎,洸喜,洸基,洸岐,洸希,洸揮,洸棋,洸毅,洸気,洸祈,洸季,洸稀,洸紀,洸貴,洸軌,洸輝,洸騎,洸己,洸碁,洸樹,洸生,洸其,洸利,洸來,洸暉,洸綺,洸熙,滉葵,滉喜,滉基,滉希,滉揮,滉季,滉稀,滉紀,滉規,滉貴,滉輝,滉己,滉公,滉樹,滉生,滉大,滉來,煌葵,煌海,煌喜,煌基,煌希,煌揮,煌毅,煌祈,煌季,煌稀,煌紀,煌記,煌貴,煌起,煌輝,煌騎,煌己,煌哉,煌樹,煌生,煌大,煌来,煌來,煌暉,煌絆,煌綺,煌熙,琥羽稀,琥羽輝,琥毅,琥貴,皓葵,皓幹,皓喜,皓基,皓希,皓揮,皓紀,皓貴,皓輝,皓己,皓樹,皓生,皓暉
こうじ	こうじ,コウジ,亨児,亨次,亨治,亨二,亨路,教二,興司,興志,興児,興次,興治,興示,興二,興路,虎次,交児,交次,交治,交二,交路,候路,倖司,倖士,倖志,倖資,倖児,倖次,倖治,倖二,倖路,光司,光史,光志,光児,光字,光慈,光次,光治,光示,光二,公司,公史,公嗣,公士,公似,公侍,公児,公寺,公慈,公次,公滋,公治,公示,公二,公路,功司,功史,功士,功志,功至,功児,功次,功治,功二,功路,効次,厚司,厚児,厚次,厚治,厚二,好司,好志,好事,好児,好次,好治,好二,好路,孔嗣,孔二,孝司,孝史,孝志,孝寺,孝次,孝治,孝二,孝之,孝路,宏司,宏史,宏嗣,宏次,宏治,宏二,宏路,工事,工児,工字,工慈,工次,工治,工二,工路,巧士,幸司,幸史,幸嗣,幸士,幸志,幸資,幸寺,幸慈,幸時,幸次,幸治,幸仁,幸二,幸路,広司,広志,広至,広児,広次,広治,広知,広二,広路,康司,康史,康嗣,康士,康志,康児,康慈,康次,康治,康示,康仁,康二,康路,弘司,弘史,弘志,弘至,弘児,弘次,弘治,弘二,恒司,恒史,恒志,恒至,恒次,恒治,恒二,昂司,昂士,昂慈,昂滋,晃司,晃史,晃嗣,晃士,晃志,晃至,晃児,晃次,晃治,晃二,晃路,更至,更児,更次,更自,更二,更路,校児,校次,校治,校二,校路,江司,江史,江志,江次,江路,洪二,浩司,浩史,浩嗣,浩志,浩至,浩児,浩慈,浩次,浩滋,浩治,浩爾,浩仁,浩二,浩弐,浩路,港児,港字,港次,港治,港示,港二,港路,甲司,甲児,甲次,甲治,甲二,甲路,皇司,皇士,皇師,皇児,皇慈,皇次,皇治,皇二,皇路,紅慈,紘司,紘史,紘士,紘治,紘二,綱二,耕司,耕史,耕嗣,耕士,耕始,耕志,耕至,耕児,耕字,耕慈,耕次,耕治,耕示,耕二,耕路,考司,考史,考志,考二,航ニ,航司,航史,航士,航志,航児,航字,航次,航治,航二,航路,行二,講児,講次,講治,講二,講路,貢司,鉱次,鋼司,鋼児,鋼次,鋼治,鋼二,鋼路,項司,項史,項志,項治,香史,香児,香字,香慈,香次,香治,香爾,香二,香路,高司,高侍,高児,高次,高滋,高治,高二,高路,鴻嗣,剛司,剛志,剛児,剛次,剛治,剛二,剛路,皐司,小宇児,小宇次,小宇治,小宇二,小宇路,小路,虹司,虹二,亘司,亘史,凰司,昊志,昊治,昊二,晄士,晄志,洽司,洽次,洽治,洸司,洸士,洸志,洸児,洸次,洸滋,洸治,洸二,滉司,滉児,滉次,滉治,滉二,滉路,煌史,煌侍,煌慈,煌滋,煌治,煌仁,皓司,皓児,皓慈,皓次,皓治,皓二,皓路
こうじゅ	光寿,光樹,公寿,功樹,孝樹,宏寿,幸寿,康朱,康寿,恒樹,昂樹,晃樹,浩寿,行寿,貢壽,皐樹,凰寿,昊樹,煌珠,煌寿
こうは	倖羽,光羽,光映,光晴,光覇,光芭,光葉,功晴,功葉,幸晴,幸波,康羽,洪波,紅覇,紅波,紅葉,紘羽,航覇,航波,項羽,皐葉,虹羽,虹晴,凰羽,昊羽,昊晴,昊芭,昊葉,滉波,煌羽,煌晴,煌巴,煌波,煌葉
こころ	快,虎々朗,志路,心秀,琥心
こすも	コスモ,越盛,越百,己主百
こはく	黄珀,乎珀,古白,弧百,湖白,湖珀,胡伯,胡葉口,胡珀,虎羽空,虎巴久,虎巴玖,虎伯,虎博,虎拍,虎白,虎舶,虎珀,誇拍,誇白,誇百,鼓博,鼓拍,瑚伯,瑚博,瑚白,瑚舶,瑚珀,倖拍,倖白,倖迫,光博,光白,光珀,孝珀,幸白,幸珀,弘珀,皇珀,剛泊,剛迫,冴覇,冴白,皐白,皐珀,子珀,小博,小白,小箔,小珀,心伯,心博,心珀,虹珀,沃珀,来白,来珀,恋白,來拍,來迫,來珀,凰伯,凰白,凰珀,煌覇,煌珀,琥,琥羽玖,琥羽空,琥巴玖,琥巴來,琥覇玖,琥伯,琥博,琥拍,琥白,琥白玖,琥箔,琥舶,琥葉玖,琥珀
さかえ	さか枝,栄衛,昌
さむ	夏夢,佐夢,左夢,沙武,沙夢,咲夢,作夢,桜夢,紗夢
さんご	サンゴ,三吾,傘五,参吾,山吾,燦吾,珊吾,珊悟,讃悟,賛悟
しいな	司衣治,雫稲
しお	志旺,志大,志雄,獅旺
しおん	シオン,梓園,梓温,梓臣,梓煌,海音,海響,祇薗,祇音,祇臣,湖音,幸恩,幸温,幸音,司苑,司遠,司恩,司温,司穏,司音,史隠,史煌,嗣苑,嗣温,嗣穏,士苑,士遠,士温,士穏,士音,士御,士勇武,士力武,子遠,子穏,子音,子臣,師溫,師苑,師恩,師温,師音,志隠,志薗,志翁,志勇武,志力武,思穏,支温,枝温,氏音,獅恩,獅温,獅穏,獅御,獅凰,糸恩,紫溫,紫御,至苑,至温,至穏,至御,詞苑,詞恩,諮苑,諮恩,諮音,賜穏,侍恩,侍音,慈音,滋音,汐苑,汐恩,汐夢,識恩,識音,雫恩,雫温,偲温,偲穏,錫音,朱遠,将恩,将穏,将音,笑溫,信恩,信温,信穏,心臣,深温,真恩,神音,是恩,是温,是穏,清恩,聖苑,聖音,知温,知穏,椎音,之温,柊恩,柊温,碧,恣恩,恣音,栞溫,栞園,栞苑,栞遠,翔恩
しき	此紀,司季,司樹,司暉,史基,史稀,史紀,史貴,史輝,史己,史樹,史暉,嗣喜,嗣稀,嗣輝,嗣己,嗣生,士喜,士揮,士毅,士貴,士輝,士騎,士樹,士生,士暉,士煌,士絆,始希,姿生,子規,市季,師希,志基,志旗,志毅,志稀,志規,志記,志軌,志輝,志騎,志祇,志己,志章,志清,志來,志暉,志綺,志熙,思喜,支葵,獅葵,獅喜,獅毅,獅稀,獅紀,獅貴,獅起,獅輝,獅騎,獅己,獅樹,獅生,獅來,獅煌,祉希,糸葵,糸軌,糸騎,糸樹,糸生,紫乙,紫伎,紫寄,紫岐,紫揮,紫期,紫気,紫輝,紫騎,紫宜,紫吉,紫杵,紫居,紫玖,紫芸,紫樹,紫章,紫清,紫聖,紫聴,紫聞,紫利,紫暉,紫煌,紫綺,紫麒,至希,至軌,至騎,詩基,詩気,詩祈,詩紀,詩記,詩貴,詩軌,詩輝,詩騎,詩暉,資喜,資貴,資樹,慈生,時葵,時希,時季,時暉,時綺,識貴,偲来,若樹,織葵,織喜,織毅,織稀,織輝,織己,信貴,新暉,芯輝,知軌,恣生
しずき	穏希,穏紀,穏輝,穏來,閑木,志寿希,雫喜,雫輝,雫来,雫來,雫暉,静喜,静基,静揮,静毅,静紀,静貴,静輝,静幸,寧揮,寧祈,靖基,倭輝,惺希,惺大,靜義,靜樹,靜來
しずく	史珠久,志寿紅,紫雫
しずる	玄琉,詩弦,雫硫
しづき	梓槻,司槻,師月,志づき,志槻,志都樹,獅月,紫槻,詩槻,識月,瞬月,新月,清月
しのぶ	毅,司延,司伸,司信,司宣,司忍,司乃武,史延,史信,史之武,史之舞,史靖,嗣延,嗣信,四伸,四信,四暢,士延,士伸,士信,士宣,士暢,士乃武,士之武,士埜武,士能武,師之武,志の武,志延,志樹,志将,志宣,志展,志乃夫,志乃武,志乃部,志之武,志之歩,志能武,志能舞,志野武,志遥,獅乃武,糸樹,至延,至伸,至信,至宣,詞之武,詩樹,詩伸,詩信,詩之武,資信,資之武,篠舞,偲寛,偲歩,守将,信,真伸,忍武
しゅら	守羅,朱空,朱良,殊羅,修羅,秀羅,鐘羅,柊愛
しゅり	守吏,守理,守俐,朱琉,朱倫,朱黎,珠離,首里,周吏,秀吏,柊浬,柊璃,柊琉
しゅん	しゅん,朱武,珠武,俊,峻,春,瞬,竣,舜,駿,准,旬,楯,淳,準,純,遵,順,惇,馴,隼,洵,詢
しゅんり	しゅんり,俊吏,俊理,俊俐,峻利,峻吏,峻凛,春利,春李,春龍,瞬理,竣吏,舜莉,駿吏,駿理,駿俐,旬俐,隼利,隼吏,隼李,隼理,詢李
しん	しん,シン,子武,伸,信,審,心,慎,新,晋,森,榛,深,申,真,神,秦,紳,臣,芯,親,進,震,清,請,大,辰,津,賑,槙,愼,晨,眞,槇
じゅき	じゅき,珠希,珠紀,寿葵,寿喜,寿嬉,寿希,寿旗,寿季,寿紀,寿輝,寿騎,寿樹,寿來,寿綺,授輝,樹希,樹季,樹輝,樹幸,樹生,樹來
じゅきあ	珠輝空,寿喜空,寿樹亜,樹希愛,樹輝亜,樹輝愛,純希亜,隼樹愛
じゅのん	じゅのん
じゅら	樹螺
すい	沙維,主維,澄一,澄生,素壱,椎,透生
すかい	すかい,空,空快,空海,結快,結海,結凱,好海,好空,皇海,子快,子海,朱魁,珠快,寿海,洲改,須佳伊,須加一,須加唯,須改,澄快,澄魁,澄凱,青空,素加一,素加唯,素可一,素可唯,透海
すなお	温,侃,砂男,質,主尚,寿直,淳生,淳夫,順,須尚,須直,須奈男,須奈雄,須那男,須那雄,澄真,是,政,清順,素夫,忠,直男,悌,朴,廉
せい	せい,犀,省,世,世伊,世依,世偉,世衣,世一,世生,世唯,瀬伊,瀬威,瀬衣,瀬一,瀬生,勢,勢衣,征,成,成惟,成壱,成生,成泉,成唯,政,整,星,晴,正,清,清葦,清維,清生,生,盛,精,聖,誠,誓,醒,青,静,靖,惺,晟,晟生,笙
せいら	星嵐,盛羅,盛良,惺一空
せな	瀨菜,瀨奈,施渚,施那,施凪,施勿,汐凪,汐流,世な,世渚,世生,瀬生,瀬乃,瀬鳴,瀬和,畝名,畝和,是成,勢七,勢成,勢奈,勢名,勢梛,征那,成永,成和,星央,星生,星薙,星鳴,星也,星来,星來,星絆,晴七,晴渚,晴成,晴也,晴梛,清成,盛那,聖永,聖渚,聖捺,聖和,誠那,誠凪,誓那,醒奈,醒凪,醒和,醒梛,青渚,青波,静流,千成,千凪,扇成,靖奈,頼南,惺央,晟己,晟七,晟就,晟成,晟那,晟凪
せら	茜良,世頼,成來,誠空
せれん	成蓮,星怜,清漣,清蓮,聖廉,聖漣,聖蓮,惺恋
せん	先,宣,専,戦,撰,潜,旋,線,羨,船,閃,禅
せんじゅ	千壽,泉樹
せんり	茜哩,茜理,茜裡,仙哩,仙李,千哩,千利,千吏,宣李,宣璃,宣里,扇利,泉浬,泉理,泉俐,洗里,旋理,旋里,旋凛,閃李,閃理,閃凛,善利,善吏,善李,善莉,亘利,亘李
そあ	希心,素歩,壮和,奏蒼,奏和,爽娃,爽空,蒼綾
そあら	天空
そう	そう,空羽,空優,宗,十優,奨,捷,梢,湘,崇,染生,曾,曽,素右,素宇,素生,素優,素侑,蘇宇,創,創宇,創生,双,叢,壮,壮生,奏,奏宇,奏羽,奏生,奏優,爽,爽宇,爽羽,爽雨,宋,惣,想,想宇,想羽,想雨,想海,想生,想優,想侑,操,早,曹,燥,相,総,綜,聡,草,荘,蒼,蒼羽,蒼生,蒼友,蒼颯,装,走,送,霜,蔵,宙優,湊,湊宇,湊卯,湊生,壯,漱,漱宇,笙,莊,藏,颯,颯優
そうは	そうは,宗波,創芭,壮波,奏羽,奏晴,奏珀,想羽,蒼羽,蒼生,蒼波,蒼葉,湊羽,颯羽,颯晴
そうら	奏羅,爽来,蒼楽,湊羅,颯空,颯良
そうわ	そうわ,空我,繰和,宗和,創羽,壮我,壮倭,壮和,奏羽,奏我,奏和,爽羽,爽和,宋和,聡倭,聡和,蒼羽,蒼環,蒼渉,蒼和,湊羽,湊環,湊輪,湊和,壯和,莊和,颯羽,颯和
そな	素南,奏凪
そなた	逸名太,該丈,供丈,具丈,空颯,詮丈,膳丈,奏空,奏統,奏翔,想那多,想那汰,想那泰,想名太,想和多,想和太,大空,備丈,翔
そら	逸良,希望,輝空,空笑,空天,空翔,十空,初楽,初羅,初良,将良,塑来,塑良,曾楽,曾良,礎良,素笑,素等,蘇楽,蘇等,蘇良,遡良,創楽,創良,壮良,奏羅,奏嵐,奏樂,想等,想麗,蒼,蒼宙,蒼来,蒼良,蒼浪,蒼昊,大雲,宙羅,宙良,天宇,天空,天翔,湊羅,湊来,湊嵐,湊良,湊來,昊楽,昊良,昊穹,翔天,翔飛,颯
そらち	空千,宙知,天地
そらは	そらは,空晴,空巴,昊晴
そわ	そわ,空羽,空和,素和,遡和,奏笑,奏輪,想環
たか	タカ,威,宇,王,学,岳,貴,丘,享,恭,教,空,敬,賢,公,昂,高,剛,皐,尚,臣,崇,嵩,多架,多芳,太佳,太香,卓,天,宝,峰,鳳,茂,誉,陸,隆,良,陵,朗,和
たけみ	岳海,岳観,岳実,岳南,岳巳,岳弥,建臣,建美,剛海,剛己,剛巳,丈美,竹見,武海,武見,武己,武実,武巳,猛美,猛巳,雄己
たまお	球央,玉於,玉夫,玉雄,珠雄,瑞男,太真央,太真緒
たまき	珂希,環暉,球貴,玉稀,玉置,玉綺,圭葵,賜己,珠桔,瑞桔,多真貴,太槙,碧杏,碧喜,碧季,碧稀,碧記,碧貴,碧輝,碧桔,碧己,碧樹,碧来,碧暉,碧綺,琳月,玲稀,玲綺,琥生
だい	だい,太,太維,太衣,太唯,打意,泰,大,大偉,大維,大一,大莞,大生,大唯,第,奈,梛伊,橙
だいあ	だいあ,星愛,太亜,太藍,泰亜,大亜,大葵,大偉亜,大雅,大空,大吾,大碧,大明,大藍,奈愛,奈吾,乃愛,乃安,乃空,乃吾,乃昂,乃充,乃明
ちかい	義偉,千海,智海
ちかげ	愛夏,愛戲,慈夏,治景,新樺,親芥,千蔭
ちかぜ	知風,智風
ちせ	知畝,直世
ちせい	ちせい,千惺,知正,地成,智成,智晴,智生,智盛,智誠,致正,祐生
ちはや	茅羽矢,茅快,茅迅,茅晴弥,茅晴矢,茅巴矢,茅隼,治早,治速,治隼,誓隼,誓颯,千逸,千栄也,千捷,千迅,千晴矢,千生弥,千馳,千覇也,千波也,千波矢,千葉夜,知羽哉,知羽八,知羽也,知羽弥,知羽矢,知快,知春也,知刃矢,知晴也,知晴矢,知生弥,知巴矢,知波矢,知勇,地駿,智逸,智羽也,智羽矢,智敬,智捷,智晴也,智晴矢,智巴哉,智巴也,智巴矢,智勇,智葉矢,稚羽矢,致早,致速,馳駿,馳隼,馳颯,祐剣,祐早,祐勇,祐颯,莉隼
ちはる	一桜,千栄,知永,知玄,知知,知日,知波瑠,地晴,地悠,智玄,智治,智全,智大,智脩,道玄,祐喜,祐玄,祐桜
ちひろ	一寛,市蒼,千祐,千栄,千玄,千大,千埜,千豊,千宥,千陽路,千翼,千熙,地央,地宏,地紘,地大,地宥,地祐,地洋
つかさ	官,恭冴,恭颯,工,宰,采,使差,司佐,司嵯,司瑳,司冴,司朔,司皐,司早,師,次一沙,次笠,主,宗,掌,職,積重,束冴,長,津佳左,津夏佐,津夏早,津果佐,津歌早,津河紗,通佳咲,通海咲,塚佐,塚沙,塚砂,塚早,紬嵩,鶴佳佐,都可査,都可勇,都夏紗,都果早,都架紗,都歌冴,都河左,都賀佐,都重,都勝佐,都嵩,統咲,弊裂,墓砂,吏颯,僚,僚紗,寮,良颯,緑栄,摑沙,摑冴
つくし	愛士,作詩,作心,尽志,創士,造志,筑志,筑孜,都詩,皓知
つくも	創守,創然,津雲,都雲
つづみ	鼓巳
つばさ	子羽紗,次葉佐,津ばさ,津羽沙,津場佐,津巴沙,津芭冴,津葉佐,津葉小,鶴羽早,天羽,都羽佐,都羽紗,都羽爽,都羽総,都羽理,都場佐,都巴佐,都巴沙,都波紗,都葉佐,都葉冴,都葉紗,飛夢,飛翼,飛翔,翼羽,翼冴,翼爽,翼翔,翼颯,翔,翔夢
てる	てる,旭,瑛,央,輝,輝流,輝琉,輝瑠,光,晃,昭,照,照琉,晴,明,曜,耀,陽,晟,暉,煌,皓
てるみ	輝己,輝巳,輝彌,光巳,照三,照味,耀海,暉実,暉仁
てん	てん,大宙,辿,佃,典,天,天夢,展,纏,点,殿,槙,槇,塡
てんし	天志,殿使,殿子,翼士
てんり	辿李,典李,天浬,天吏,天裡,天厘,殿李
とあ	音明,叶逢,叶空,叶翔,虎愛,虎空,士阿,士愛,士逢,士蒼,疾空,十葵,十安,十吾,十碧,純空,人吾,仁亜,仁蒼,仁暖,説亜,説愛,跳空,兎和,堵空,塗愛,徒亜,徒安,徒明,斗阿,斗逢,斗葵,斗絢,斗吾,斗蒼,斗碧,斗明,杜亜,杜葵,杜空,杜碧,杜麻,杜和,登亜,登空,都安,都吾,都碧,冬愛,祷亜,透空,飛亜,飛充,百亜,敏空,富空,友空,利亜,橙吾,翔阿,翔逢,翔葵,翔央,翔雅,翔開,翔吾,翔秋,翔上,翔蒼,翔有,翔和,翔亞,詢和
とい	とい,十依,十惟,十維,仁衣,仁唯,図維,斗偉,斗夷,斗惟,斗維,斗生,斗唯,登惟,登衣,都偉,冬維,飛衣,飛生,翔依,翔威,翔惟,翔壱,翔生,翔泉
とし	敏,とし,英,鋭,穏,喜,季,紀,亨,暁,慧,才,寿,秋,十士,十詩,俊,舜,駿,順,章,信,迅,澄志,星,聡,知,斗士,斗志,斗紫,杜士,登仕,登史,登士,登市,登師,登志,登支,登肢,登至,登之,途慈,都司,都史,都志,度士,燈志,年,隼,飛士,稔,利,利士,理,暦,禄,壽,翔梓,翔士,翔志,翔獅
としみ	淑己,淑巳,俊己,俊巳,駿実,惇心,年海,年己,敏海,敏見,敏己,敏巳,利己,利三,利実,利巳
とも	栄,音茂,皆,叶,寛,幹,義,興,元,誠,曹,大,禎,斗望,斗茂,杜萌,翔桃,翔茂
とわ	永環,永湧,詠愛,乙羽,乙我,乙輪,音我,音環,音湧,音輪,兜倭,虎羽,虎和,采我,士倭,士和,士翔,時和,十生,十湧,人羽,人我,人環,人吾,人輪,仁環,仁吾,仁湧,仁輪,仁倭,征我,征和,説羽,説和,太吾,大羽,大志,塗和,徒環,徒和,斗王,斗我,斗吾,斗湧,斗輪,斗倭,斗翔,杜湧,登吾,登倭,途和,都王,都吾,都弁,都湧,土和,東羽,東環,東輪,灯羽,灯和,燈羽,透環,鳶翔,泊和,飛八,飛弁,飛輪,飛翔,百羽,敏和,富羽,富弁,豊王,門我,友輪,利羽,利和,橙我,翔王,翔我
なお	侃,公,七於,七保,七麻,修,奈夫,凪旺,凪臣,凪青,凪大,凪男,凪穂,凪勇,凪雄,凪良,凪朗,南旺,南渚,南朋,南朗,和寛,和保,和穂
なぎ	永義,夏樹,成義,奈岐,那技,那義,凪伎,凪毅,凪季,凪稀,凪規,凪貴,凪義,凪樹,凪生,銘芸,和宜,和義,梛希,梛義
なぎさ	渚幸,渚総,渚勇,七岐佐,七岐嵯,渚幸,渚嵯,渚差,渚査,渚瑳,渚爽,渚総,渚茶,渚勇,渚理,成義沙,汀皐,奈岐佐,那義佐,凪幸,凪些,凪嵯,凪左,凪差,凪査,凪作,凪総,凪朝,凪勇,凪理,凪颯,薙幸,薙総,和佐,和瑳,和総,和颯,梛幸,梛嵯,梛砂,梛皐,梛総,梛聡,梛勇,梛理,梛惺
なごむ	那幸武,那幸夢,和幸武,和幸夢,和武,和舞,和睦
なさ	那砂
なつ	永継,永都,夏柘,己都,成津,奈柘,那都,那通,那斗,凪司,凪通,凪柘,薙都,捺詰,捺継,捺紬,捺都,南都,波柘,和都,梛詰,梛継,梛月,梛通,梛柘,梛斗
なつき	夏幹,夏基,夏旗,夏毅,夏気,夏祈,夏規,夏起,夏軌,夏騎,夏鬼,夏桔,夏暁,夏示,夏章,夏熙,懐輝,菜津貴,菜津暉,菜都毅,菜都規,菜都輝,七都生,成槻,成都希,眺月,奈都生,那津貴,那津樹,那兎貴,那都輝,凪槻,凪斗毅,捺幹,捺伎,捺基,捺旗,捺桔,捺玖,捺木,捺綺,南津貴,南都季,楠月,納月,無月,名津樹,和調,和槻,梛津暉
なつひ	夏灯
ななせ	七成,七誠,成七世,奈七星,凪々瀬,凪々星,南々世
なり	育,克,哉,慈,柔,成,晴,徳,也,令,礼
なる	為,茄瑠,功,七留,樹瑠,渚琉,匠,誠,登,徳,凪流,捺琉,南流,波流,稔,名留,和琉,和瑠,梛流
なるみ	匠海,匠弥,成幹,成巨,成己,誠海,誠己,誠実,誠巳,稔生,鳴弥
にき	似樹,仁生,仁来,仁暉,二樹,弐岐,弐希,弐騎,弐玖,弐来,類貴
にじ	似時,仁慈,二児,二字,二次,二治,二地
にちか	仁哉,仁千佳,仁知香,仁稚蘭,二哉,二智夏,二稚加,二稚嘉,二稚夏,虹誓,日海,日哉
にの	仁之
ねお	ねお,音於,音旺,音乙,音雄,音零,願愛,子央,新,祢生,寧於,寧王,寧力,寧凰,福生,嶺央,嶺生,煉起,練央
ねおん	輝音,子音,祢苑,寧園
のぞみ	希子,希深,希真,希壬,希湊,希洋,望己,望子,望真,望道,望洋,望良
のり	玄,実,周,則,知,哲,統,徳,範,文,法,望理,雄,律,緑
はおと	羽乙,羽織斗,巴音,波緒斗
はおん	はおん,巴温,波音,芭温,芭音
はく	はく,羽久,羽恭,羽玖,羽駆,羽駈,羽駒,羽空,羽功,羽紅,羽来,羽來,羽徠,羽琥,栄空,栄功,華琥,牙琥,春玖,春空,春紅,晴丘,晴久,晴宮,晴玖,晴駆,晴空,晴公,晴孔,晴紅,晴来,晴來,晴徠,晴琥,巴紅,巴來,覇,覇空,覇來,覇琥,杷玖,杷來,波久,波玖,波空,波紅,波琥,琶琥,破空,芭駆,芭孔,芭紅,伯,伯久,伯玖,伯空,伯孔,伯来,伯琥,博,博久,拍,柏,泊,白,白久,白玖,白空,白琥,箔,舶,薄,迫,百,芙琥,朴,葉丘,葉久,葉玖,葉空,葉功,葉紅,葉來,葉琥,遥空,蓮來,珀,珀久,珀玖,珀空,珀来
はつき	羽槻,華月,初葵,初喜,初揮,初輝,初月,初暉,覇月,波槻,芭月,芭槻,肇希,肇紀,肇貴,肇月,肇槻,八希,八起,八輝,八月,八槻,発葵,発揮,発紀,葉築樹,蓮月,珀月
はやみ	逸実,快実,初陽臣,早水,早巳,速,隼水,隼美,颯三,颯実,颯水
はる	羽海,羽児,羽溜,羽隆,羽塁,羽惺,栄流,栄琉,栄瑠,永,花涙,華児,開,元,玄,合,始,歯流,時,春児,昭,刃流,晴輝,晴隆,生留,青空,馳流,馳琉,張溜,跳流,東,覇,覇流,覇琉,覇留,波溜,波籠,派瑠,伯流,伯琉,伯瑠,八瑠,敏,孟,冶,悠琉,葉海,葉輝,葉響,遥大,遥琉,流,和晴,晏,榮琉,榮瑠,颯琉,遙留
はるか	永翔,治加,晴一,晴河,青海,青空,大翔,暖嘉,暖日,宙,波琉果,悠河,悠翔,葉留加,葉留花,葉瑠佳,葉瑠加,遥哉,陽火,陽珂,流嘉,遼河,遼空,遼翔,櫻華,颯斗,遙嘉,遙賀,遙哉,遙楓,遙芳
はるせ	絢成,春成,春星,春生,春瑠世,榛世,榛成,晴瀬,晴成,暖瀬,暖成,暖星,波留世,悠瀬,悠成,悠星,悠生,悠晟,遥瀬,遥成,遥星,遥惺,陽瀬,陽成,陽晴,陽生,陽聖,陽青,遙瀬
はるひ	栄光,栄飛,栄陽,喜一,喜陽,啓陽,元陽,治緋,春火,春光,晴一,晴冴,晴燈,晴裕,大斐,暖啓,暖陳,暖燈,暖飛,暖氷,日陽,覇陽,悠一,悠冴,悠飛,悠柊,悠桧,悠暉,遥一,遥光,遥冴,遥燈,遥比,陽一,陽昆,遼燈,遼日,令陽,晏緋,榮柊,櫻陽,脩光
はるみ	桜心,桜生,桜弥,治海,治己,治巳,治弥,春洋,榛己,榛巳,晴光,晴深,暖心,悠目,遥光,陽湊,遼海,遙巳
はれ	羽伶,映玲,晴令,晴零,晴黎,覇玲,波麗
ひいらぎ	柊季
ひかり	希望,光星,光律,光凌,日翔利,飛雁,陽科理,陽香俐,陽日理,陽日俐,熙律
ひかる	一嘉琉,一嘉瑠,瑛,輝琉,光蕗,光隆,光塁,晃琉,惹夏流,照,閃,閃光,太陽,弾夏流,抽夏流,日佳瑠,日夏流,日夏琉,日夏留,日翔琉,飛佳琉,飛夏琉,飛駆,耀,陽佳琉,陽加琉,陽夏流,陽夏琉,陽華琉,陽光,流星,晄琉,晄塁,暉流,煌,絆輝,熙
ひさき	永暉,央喜,央基,喜葵,喜生,喜暉,久喜,久期,久稀,久輝,久己,久樹,久木,向輝,寿葵,寿稀,寿起,寿輝,寿來,尚希,尚生,長稀,灯咲,緋皐樹,飛咲,悠幹,悠喜,悠希,悠稀,悠輝,悠生,悠暉,陽希,陽向,陽生
ひじり	聖利,聖吏,聖理,飛士利
ひづき	柊槻
ひづる	緋敦,飛弦
ひとは	一颯
ひなか	雛榎
ひなき	陽輝,陽樹,陽生,陽絆
ひなせ	陽世,陽南世,陽南瀬,陽名世,陽名瀬
ひなり	一晴,冴成,柊成,柊晴,陽哉
ひびき	韻生,響基,響揮,響毅,響軌,響騎,響義,響玖,響城,響大,燈比揮,日々伎,日々祈,日々稀,日々記,日々軌,日々暉,日比喜,日比樹,比々希,比々紀,比日樹,飛未輝,陽々季,陽々稀,陽々紀,陽々軌,陽々樹,陽々生,陽々来,陽々暉,陽響,陽樹,陽美季,陽美記
ひろ	寬,一呂,一路,迂,丑,栄,衛,演,賀,解,恢,外,拡,郭,完,官,簡,緩,巨,勲,啓呂,敬,厳,玄,戸,梧,光,光呂,公,厚,口,康,洪,衡,郊,鉱,豪,混,四,周,宗,拾,衆,潤,助,祥,丈,仁,碩,先,宣,祖,測,孫,太,泰,大陽,拓,達,谷,坦,展,転,都,燈侶,燈亮,洞,篤,日路,漠,氾,汎,披,比蕗,比路,緋侶,緋路,飛芦,飛炉,飛路,柊,彦,普,聞,豊,勃,明,門,野,弥,宥,容,陽侶,陽亮,陽良,陽炉,陽路,陽露,陽論,昊,皓
ひろみ	祐良,一二三,栄海,衛海,央海,寛海,寛己,寛三,寛実,寛巳,啓海,啓観,啓味,景海,玄海,光海,公海,公巳,宏己,宏三,宏生,宏巳,宏實,広三,広太,広巳,広弥,弘巳,弘已,浩海,浩己,浩三,浩満,浩巳,紘己,紘弥,丈美,碩弥,蒼海,蒼心,蒼生,蒼未,泰観,泰三,大己,大三,大実,大美,拓心,拓味,宙海,宙心,宙未,宙巳,篤海,博巨,博己,博三,博味,博洋,博實,比呂実,明海,宥海,宥心,祐海,裕三,裕視,裕望,洋海,洋実,洋未,廣見,廣三,廣実,廣味,洸海,滉海,滉巳,皓深
ふう	歩憂
ふく	吹,夫玖,冨久,芙来,芙來,風玖,風空,福久,福九,歩久,歩玖,歩功
ふじ	二士,二二,不二,富司,富治,芙爾,風士,風道,歩士
ほし	星翔,保志,歩史,歩嗣,歩士,歩志,歩詩,穂詩
ほたる	笑大,星大流
ほまれ	秀希,秀稀,保満玲,歩実玲,輔希,輔真玲,穂満玲,誉令,誉伶,穗希
まあさ	万咲
まおん	真穏
まこと	マコト,愛優人,一,雅琴,学,款,実琴,実采,実士,実仁,周,周采,充,純人,信琴,信人,慎,真慧,真古登,真呼人,真己登,真虎斗,真瑚,真士,真事,真十,真信,真心人,真人,真仁,真誠,真大,真斗,真杜,真登,真飛,真和,正,正誠,精,誠都,誠央,誠虎,誠士,誠心,誠人,誠仁,誠斗,誠登,誠都,誠翔,節,忠,諦,惇,任,馬胡都,睦士,麻己斗,麻思,麻事,麻殊,万詞,命,理,亮人,良,實,摯,洵人,眞己斗,眞采,眞士,眞事,眞寿,眞人,眞斗,眞登,眞都,茉信
まさ	一,幹,匡,傑,賢,公,才,勝,将,信,真,真嵯,真左,真差,真査,真沙,仁,征,政,正,聖,誠,斉,壮,直勇,麻佐,麻砂,柾,雄,諒,和,將,應,晟,眞
まさみ	允実,雅己,雅三,雅深,雅巳,匡省,剛海,勝己,勝巳,将己,将実,将巳,昌己,昌三,昌南,譲閲,真見,真己,征実,征巳,政己,政三,政巳,正幹,正己,正三,正視,正身,正水,正巳,正已,誠巳,柾実,優己,優光,優真,眞佐己
ますみ	益海,益己,益実,益巳,升己,升巳,真朱美,真順美,澄,誠純,増海,増見,増実,増巳,増實,万砂美,万寿三,万栖
まとい	真翔偉
まなつ	末那津
まひる	舞日瑠
まひろ	益景,益大,雅拓,希寛,希宏,希弘,希紘,希大,希拓,希博,希洸,希皓,稀央,稀寛,稀宏,稀広,稀弘,稀紘,稀大,稀優,稀裕,稀廣,稀洸,稀滉,蒔央,蒔玄,蒔大,蒔宙,実敬,守啓,守敬,守宏,守紘,守宙,真勲,真敬,真玄,真浩,真助,真恕,真仁,真泰,真拓,真日路,真明,真佑,真祐,真廣,真熙,正紘,正泰,誠紘,誠大,誠宙,大滉,直央,直寛,直啓,直敬,直光,直宏,直広,直大,直洸,馬広,馬弘,馬紘,馬大,舞啓,舞祐,摩尋,摩大,摩拓,摩明,磨央,磨嘉,磨啓,磨玄,磨広,磨弘,磨紘,磨大,磨拓,磨優,磨祐,磨裕,磨洋,磨廣,磨滉,麻勲,麻啓,麻鉱,麻大,麻拓,麻祐,麻皓,末紘,末滉,麿寛,万啓,万鉱,万丈,万碩,万洋,万礼,万廣,万熙,満大,満宙,優光,優宙,優洋,實紘,實優,眞敬,眞玄,眞宏,眞浩,眞宗,眞大,眞拓,眞比呂,眞祐,眞洋,眞廣,眞昊,眞洸,眞滉,眞皓,茉碑呂,茉啓,茉滉
みおう	海王
みおと	みおと,海央途,海央翔,海音,海吟,海大斗,海和都,海和翔,己音,光吟,深音,仁乙,美旺士,美桜斗,望音,弥音,澪兜,澪采,澪人,澪斗,澪登,澪土,澪刀,澪翔
みづき	海都希,三綺,史津己,充希,生月,巳津起,巳都樹,湊月,澪月
みなみ	皆波,挙己,南己,南巳,未七海,未渚実,湊己,眞波
みのり	胤典,海慶,海則,海法,三実,三法,史賀,史恭,実德,実希,実慶,実士,実則,実範,充則,心矩,親実,仁紀,壬則,泉徳,美寛,美実,望令,未乗,未徳,稔織,稔哩,稔琉
みらい	海雷,海蕾,幹頼,観来,観來,光頼,光來,三礼,実頼,充頼,充萊,申来,申雷,美良生,望萊,満雷,未頼,未良衣,魅来,巳礼,湊來,明日,明来,弥頼
みらん	海嵐,海欄,光嵐,深藍,望嵐,未嵐,弥覧
みろく	海陸,三陸,三六,三六九,実禄,充禄,心陸,心禄,深禄,身六,壬陸,壬禄,水六,美呂紅,美六,望禄,満禄,未陸,魅陸,魅侶玖,魅呂玖,魅呂紅,魅六,魅禄,魅録,巳禄,巳録,弥鹿,弥侶紅,弥緑,弥呂玖,弥六,弥麓,彌六
むぎ	六義
むつ	輯,夢詰
むつき	ム月,向月,睦黄,睦幹,睦基,睦祈,睦起,睦騎,睦宜,睦義,睦興,睦公,睦其,睦大,睦槻,睦來,睦暉,睦絆,無月,陸葵,陸揮,陸稀,陸義,陸月,陸己,陸樹,陸生,陸來,陸奧樹,陸絆,六葵,六希,六貴
めぐむ	德,恩武,芽,芽武,恵武,恵務,恵六,仁武,仁六,徳,龍
もと	基,元,源,朔,守人,初,征,礎,素,太,智,統,要
ゆあん	結夢,夢庵,夢行,癒安,癒庵,癒晏,唯晏,優行,優晏,勇行,悠安,悠庵,悠按,悠案,悠行,悠晏,柚庵,由安,由庵,遊安,遊庵,遊按,遊晏,雄杏,雄行,侑晏
ゆう	祐,惟羽,弓雨,結心,結祐,湯宇,湯羽,湯生,夢宇,夢海,夢樹,夢生,愉宇,癒優,唯生,唯佑,唯憂,佑生,佑有,優樹,優佑,勇宇,勇羽,勇佑,友宇,友生,友佑,友有,宥優,悠佑,悠優,有海,有生,有佑,有憂,有祐,祐生,裕右,裕雨,裕海,裕胡,裕生,裕優,遊羽,遊生,雄宇,雄有,融,夕侑,侑宇,侑於,侑海,侑胡,喩羽
ゆうさ	結作,尤彩,佑沙,優采,勇佐,勇冴,悠然
ゆうひ	郁飛,郁柊,熊斐,結光,結燈,結波,結飛,結枇,諭宇陽,佑広,佑燈,佑斐,佑飛,優生陽,優斐,優秘,優桧,勇一,勇光,勇飛,友斐,友飛,宥飛,宥陽,悠光,悠広,悠冴,悠博,悠斐,悠飛,悠柊,悠桧,有冴,有斐,有飛,柚緋,湧日,湧飛,湧陽,由宇陽,由羽飛,由光,由波,由斐,由緋,由侑陽,祐冴,祐飛,裕燈,裕日,裕飛,邑柊,雄灯,雄燈,雄日,雄彼,雄斐,夕宇燈,夕柊,侑光,侑広,侑緋,侑飛,侑枇,侑毘,侑柊,釉飛
ゆうほ	優浦,勇帆,勇歩,勇穂,友秀,悠宝,有保,有歩,湧帆,祐蒲,祐保,祐圃,祐歩,祐甫,祐補,祐哺,遊帆,雄帆,侑蒲,侑帆,侑保,侑甫
ゆうら	佑良,優羽良,優等,勇良,友羅,悠楽,悠羅,悠来,悠嵐,悠蘭,悠良,祐良,遊楽,遊宙,雄羅,侑楽
ゆうり	祐吏,祐李,祐理,祐里,祐稟,ゆう李,郁吏,郁李,結羽利,結羽吏,結心李,結梁,結侑俐,結黎,尤理,佑浬,佑優莉,佑憂璃,佑利,佑裡,佑陸,佑琉,佑凌,佑厘,優羽吏,優羽李,優羽梨,優生吏,優生俐,優陸,優龍,優力,優厘,優綸,勇吏,勇李,勇梨,勇理,勇璃,勇令,勇俐,勇凛,友亥,友宇凜,友栗,友裡,友陸,友律,友力,友黎,宥李,宥俐,宥凛,悠宇里,悠羽利,悠羽吏,悠羽李,悠羽俐,悠生俐,悠裡,悠陸,悠旅,悠凌,悠良,悠力,悠倫,悠厘,憂吏,憂李,憂理,有羽李,有羽里,有浬,有織,有哩,有旅,有麗,柚樹,柚織,柚利,柚理,柚稟,湧利,湧吏,湧李,湧裡,湧里,湧俐,湧凛,湧莉,由宇利,由哩,祐陸,遊利,遊梨,遊理,遊里,遊凛,雄浬,雄利,雄李,雄梨,雄理,雄倫,雄琳,雄俐,雄莉,夕利,夕吏,夕李,夕麗,夕俐,侑宇理,侑宇莉,侑浬,侑裡,侑立,侑旅,侑凌,侑良,侑陵,侑厘
ゆうわ	結生羽,結湧,佑環,優環,優葉,勇羽,勇環,勇和,友環,悠笑,悠湧,悠和,柚羽,柚和,由和,祐羽,裕和,雄和,迪羽,迪和
ゆきじ	ゆきじ,維志,敬志,幸児,幸次,幸滋,幸治,幸示,幸二,行次,行二,至慈,雪二,千慈,之司,來志,諧侍,逞慈
ゆずき	ゆず稀,ゆず樹,弓月,結珠稀,結珠輝,結寿輝,結寿来,譲毅,譲貴,譲樹,譲生,譲暉,禅己,禅樹,優月希,優朱稀,優寿希,優寿輝,悠珠希,悠珠樹,悠寿稀,悠寿輝,柚黄,柚岐,柚軌,柚騎,柚章,柚大,柚利,湧珠樹,由珠樹,祐珠希,祐珠樹,裕貴,夕珠希,橙生,讓輝
ゆづる	祐弦,弓鶴,弦,諭弦,唯弦,佑弦,優絃,勇弦,勇鶴,友絃,悠弦,悠絃,悠鶴,有絃,柚絃,祐弦,祐絃,祐鶴,裕弦,裕絃,裕都瑠,雄弦,夕絃,侑弦
ゆめじ	夢士,夢至,夢次,夢滋,夢治,夢二
よう	影,永,泳,瑛,詠,八,夜羽,誉優,誉憂,庸,庸羽,揚,擁,様,耀生,耀優,葉海,要,要羽,踊,陽宇,陽生,養,應,搖,瑶宇,瑶生,謠,頌,遙
よし	よし,愛,芦,惟,允,悦,佳,佳志,嘉,快,凱,玩,喜,嬉,儀,義,吉,圭,慶,賢,好,孝,巧,幸,克,祉,至,慈,治,実,淑,勝,祥,仁,世士,世志,静,善,善志,繕,禎,徳,能,美,彦,彬,福,芳,夜詩,由,余思,与志,与慈,理,良,良士,禄,與四,逞
らい	らい,楽生,光,瀬,羅依,羅偉,羅維,羅衣,羅生,来,来移,来癒,来李,頼,雷,良伊,良偉,良威,良惟,良衣,良生,礼,麗以,麗偉,來,來以,來依,來衣,徠,徠維,禮,蕾,萊
らいか	頼可,頼嘉,雷火,雷海,礼河,礼哉,徠夏,徠叶,徠芳,徠和,萊芳
らいち	楽市,羅一,羅已智,来壱,来地,来智,頼知,雷一,雷市,雷知,雷地,雷智,良依知,礼知,礼智,來一,來壱,來知,來智,徠茅,徠智,蕾一,蕾市,蕾智,萊一,萊茅
らいむ	月夢,奏夢,来舞,来睦,頼武,頼夢,頼矛,雷武,礼睦,礼夢,來武,來舞,徠睦
らいら	雷羅,蕾羅
らいり	羅唯龍,来李,雷里,雷令,雷凛,礼理,礼凛,礼莉,來吏,來李,來理
らいる	瀬琉,羅維琉,頼琉,雷琉,雷麟,礼琉,來瑠,徠衣琉,徠琉,萊流,萊琉,萊留,萊瑠
りある	理吾隆
りあん	利庵,利行,利晏,吏晏,李庵,李晏,璃庵,琉杏,凌杏,俐安,俐庵,凛晏
りお	浬愛,浬弦,鯉生,利緖,利王,利恩,利皇,利勇,利雄,利和,吏旺,吏王,吏翁,吏皇,吏臣,吏生,吏伯,吏負,吏雄,吏郎,吏和,李王,李皇,李大,李男,李夫,李雄,李零,梨夫,梨雄,理旺,理皇,理士,理壮,理男,理伯,理勇,理雄,理朗,璃阿,璃王,璃皇,璃士,璃臣,璃大,璃夫,璃碧,璃雄,璃陽,璃煌,里王,里雄,陸王,律央,律和,琉央,琉皇,琉大,琉和,龍旺,龍桜,龍生,凌央,凌桜,凌陽,凌和,涼央,涼音,涼生,稜央,倫音,倫緒,琳凰,麟音,麗王,麗鳳,麗零,麗和,俐於,俐旺,俐王,俐御,俐皇,俐百,俐鳳,俐勇,俐雄,俐陽,俐郎,俐和,凛士,凛大,凛勇,莉王,莉弦,莉士,莉将,莉推,莉青,莉勇,莉雄,黎音,凜王,凜大,凜勇,凜雄
りおん	偉恩,聖央,利園,利遠,利央,利恩,利温,利穏,吏遠,吏温,吏臣,梨溫,理穏,理御,理臣,璃遠,里遠,里恩,律音,琉苑,琉遠,琉穏,龍恩,龍音,凌音,諒音,陵恩,力音,琳央,琳温,怜穏,麗恩,俐遠,俐温,俐穏,俐臣,凛遠,凛臣,凛星,莉星,黎音
りずむ	音楽,李須夢,理澄
りつ	亥継,亥津,亥都,浬亜,浬次,浬尽,浬槻,浬鶴,浬斗,織柘,哩嗣,椋月,椋紬,椋斗,利継,利嗣,利尽,利通,利柘,利斗,吏都,吏亜,吏継,吏弦,吏嗣,吏悉,吏尽,吏繕,吏柘,吏斗,吏紡,吏律,吏連,吏亞,李亜,李継,李次,李悉,李積,李通,李斗,李律,梨柘,理都,理継,理月,理嗣,理尽,理築,理通,理柘,理斗,理連,璃月,璃次,璃通,璃柘,璃斗,裡継,裡尽,裡津,里継,里嗣,里通,里柘,里斗,律月,律弦,律図,律槻,律紬,律斗,律紡,立津,立都,流都,稜継,稜悉,稜都,俐亜,俐継,俐月,俐弦,俐嗣,俐尽,俐積,俐通,俐柘,俐斗,俐附,俐律,凛継,凛通,凛斗,慄,稟都,莉都,莉継,莉嗣,莉悉,莉通,莉柘,莉斗,黎斗,凜都
りと	亥兜,浬音,浬兜,浬士,浬斗,浬杜,浬都,浬翔,哩十,哩人,哩徒,哩斗,哩都,有翔,利士,利人,利仁,利太,利徒,利斗,利杜,利登,利飛,利翔,吏音,吏叶,吏采,吏疾,吏人,吏徒,吏斗,吏渡,吏登,吏冬,吏飛,吏利,吏翔,李都,李戸,李士,李釈,李十,李人,李仁,李徒,李斗,李杜,李登,李冬,李燈,李飛,李橙,李翔,梨戸,梨人,梨達,梨杜,梨登,梨把,梨飛,梨百,理音,理采,理士,理十,理人,理兎,理徒,理斗,理登,理途,理土,理刀,理把,理飛,理敏,理橙,璃虎,璃士,璃人,璃仁,璃登,璃土,璃冬,璃泊,璃飛,璃百,璃与,璃留,璃橙,璃翔,裏兎,裡乙,裡士,裡斗,裡杜,裡都,裡土,里士,里人,里説,里登,里燈,里百,里富,里橙,里翔,陸士,陸斗,流翔,琉人,琉仁,琉斗,琉翔,旅人,亮智,凌人,凌仁,凌翔,稜土,力与,瑠人,怜士,鈴飛,麗音,麗仁,麗徒,麗斗,麗杜,麗冬,麗翔,俐音,俐士,俐十,俐人,俐仁,俐杜,俐登,俐冬,俐把,俐飛,俐翔,凛戸,凛士,凛十,凛人,凛仁,凛斗,凛杜,凛登,凛土,凛冬,凛飛,凛門,凛翔,莉士,莉十,莉人,莉兎,莉徒,莉杜,莉冬,莉飛,莉豊,莉門,黎音,黎采,黎人,黎兎,黎斗,黎登,黎都,黎飛,黎翔,凜士,凜人,凜仁,凜斗,凜都,凜飛,凜翔
りょう	綾海,綾生,綾佑,漁,享,梨陽,理陽,竜,龍生,侶右,侶烏,侶羽,侶雨,侶卯,侶鵜,侶樹,侶生,侶兎,侶優,侶有,旅宇,旅羽,旅雨,旅卯,旅兎,亮羽,亮生,亮佑,凌宇,凌羽,凌海,凌生,涼羽,涼央,涼生,猟,稜羽,稜央,稜生,良生,諒央,諒有,遼羽,遼生,量,陵生,領,嶺生,怜生,霊,呂兎,凉生,凛陽,崚宇,崚羽,崚生,燎生
りん	璃武,隣
るあ	琉安,琉吾,琉充,留吾,隆吾
るい	類,海,月星,光斐,蕗緯,劉偉,劉惟,流伊,流偉,流夷,流威,流意,流維,流亥,流一,流壱,流光,流行,流泉,琉,琉葦,琉位,琉偉,琉夷,琉威,琉意,琉椅,琉異,琉緯,琉井,琉亥,琉一,琉壱,琉云,琉居,琉五,琉行,琉色,琉泉,琉鋳,琉猪,琉道,琉斐,琉要,琉倭,琉已,留位,留偉,留夷,留委,留威,留一,留壱,隆伊,隆偉,隆夷,隆惟,隆一,隆生,瑠位,瑠囲,瑠威,瑠意,瑠為,瑠緯,瑠井,瑠郁,瑠壱,瑠云,瑠行,瑠斐,瑠已,塁斗,塁唯
るう	流,流雨,流優,琉生,琉優,琉友,琉有,琉侑,瑠生
るか	瀧翔,劉架,流可,流海,流環,流翔,琉河,琉火,琉駕,琉莞,琉駆,琉圭,琉哉,琉日,琉珈,留海,隆嘉,隆夏,隆叶,瑠菓,瑠駕,瑠克,塁翔
れい	令維,伶伊,伶偉,伶惟,伶為,伶已,怜以,怜伊,怜偉,怜威,怜好,怜已,玲伊,玲委,玲威,玲惟,玲椅,玲為,玲緯,玲亥,玲一,玲行,玲泉,玲要,玲倭,玲已,麗威,麗唯,蓮生,莉青
れん	練,レン,鎌,琉,伶武,怜々,怜武,玲武,漣楓,練,蓮楓,蓮夢,錬,澪
わかさ	若狭,若狹,稚桜
